bgrp,IBuff_Pop,SBuff_Pop,Buff_Pop,Buff_Pct,Lane_PctSB,Lane_PctIB
170310101001,442,82,524,84.9300003052,32.0499992371,67.9499969482
170310101002,1793,46,1839,78.9599990845,0.930000007153,99.0699996948
170310101003,1589,256,1845,98.1399993896,39.2099990845,60.7900009155
170310102011,1369,60,1429,98.6900024414,47.8600006104,52.1399993896
170310102012,3083,750,3833,99.7099990845,38.2700004578,61.7299995422
170310102013,1023,110,1133,100.0,74.3399963379,25.6599998474
170310102021,1206,46,1252,93.7099990845,9.71000003815,90.2900009155
170310102022,965,588,1553,98.9800033569,39.0800018311,60.9199981689
170310103001,317,586,903,96.2699966431,75.8199996948,24.1800003052
170310103002,1881,216,2097,98.1299972534,33.0699996948,66.9300003052
170310103003,830,712,1542,95.4199981689,64.9899978638,35.0099983215
170310103004,508,864,1372,94.75,86.8300018311,13.1700000763
170310104001,1147,221,1368,100.0,31.3899993896,68.6100006104
170310104002,497,268,765,91.0699996948,70.4100036621,29.5900001526
170310104003,1881,599,2480,92.6399993896,28.2800006866,71.7200012207
170310105011,459,376,835,93.6100006104,46.7400016785,53.2599983215
170310105012,1520,295,1815,97.5299987793,38.2799987793,61.7200012207
170310105013,888,335,1223,93.8600006104,68.8000030518,31.2000007629
170310105021,1003,265,1268,100.0,25.0200004578,74.9800033569
170310105022,1553,151,1704,92.5599975586,49.5499992371,50.4500007629
170310105031,1460,0,1460,95.3000030518,10.3299999237,89.6699981689
170310105032,621,0,621,77.2399978638,0.0,100.0
170310106001,937,954,1891,98.5400009155,66.9300003052,33.0699996948
170310106002,261,591,852,95.5199966431,91.5299987793,8.47000026703
170310106003,1039,223,1262,67.5999984741,0.0,100.0
170310106004,69,543,612,41.5200004578,0.0,0.0
170310107011,1000,630,1630,98.3099975586,75.5299987793,24.4699993134
170310107012,1799,360,2159,100.0,60.4900016785,39.5099983215
170310107021,1549,0,1549,100.0,0.0,100.0
170310107022,1034,0,1034,94.1699981689,0.0,100.0
170310107023,1533,78,1611,100.0,27.6399993896,72.3600006104
170310107024,848,30,878,98.2099990845,28.7099990845,71.2900009155
170310201001,1931,408,2339,99.0299987793,38.3600006104,61.6399993896
170310201002,1333,204,1537,95.7600021362,39.6399993896,60.3600006104
170310202001,1075,425,1500,89.7699966431,48.2700004578,51.7299995422
170310202002,1125,125,1250,84.4000015259,27.3400001526,72.6600036621
170310202003,1229,248,1477,87.6600036621,37.1699981689,62.8300018311
170310202004,1803,118,1921,100.0,23.2299995422,76.7699966431
170310203011,1184,172,1356,88.5699996948,62.8800010681,37.1199989319
170310203012,641,17,658,48.0999984741,0.0,0.0
170310203013,1197,411,1608,85.9899978638,34.5800018311,65.4199981689
170310203021,1128,206,1334,100.0,31.8400001526,68.1600036621
170310203022,513,289,802,81.3399963379,38.2200012207,61.7799987793
170310203023,1887,84,1971,84.7399978638,7.63999986649,92.3600006104
170310204001,699,79,778,96.1699981689,57.2799987793,42.7200012207
170310204002,1015,314,1329,87.5500030518,28.8299999237,71.1699981689
170310204003,1055,521,1576,82.0800018311,35.7700004578,64.2300033569
170310205001,2140,372,2512,100.0,44.7599983215,55.2400016785
170310205002,901,0,901,94.7399978638,0.0,100.0
170310205003,980,677,1657,94.0899963379,66.1500015259,33.8499984741
170310205004,985,66,1051,94.6800003052,7.63000011444,92.3700027466
170310206011,827,565,1392,75.7300033569,49.9700012207,50.0299987793
170310206012,2649,89,2738,89.6800003052,6.92000007629,93.0800018311
170310206013,1360,159,1519,100.0,17.5100002289,82.4899978638
170310206021,950,224,1174,100.0,14.25,85.75
170310206022,1099,21,1120,99.9100036621,4.44999980927,95.5500030518
170310206023,919,57,976,90.6200027466,0.0,100.0
170310206024,87,203,290,29.8700008392,0.0,0.0
170310207011,689,109,798,94.8899993896,33.8699989319,66.1299972534
170310207012,859,11,870,99.7699966431,29.3299999237,70.6699981689
170310207021,1420,28,1448,75.4199981689,10.4899997711,89.5100021362
170310207022,2482,0,2482,96.1299972534,1.92999994755,98.0699996948
170310207023,1672,0,1672,95.0500030518,13.4300003052,86.5699996948
170310207024,835,30,865,84.1399993896,5.76999998093,94.2300033569
170310208011,1497,38,1535,94.4599990845,17.4699993134,82.5299987793
170310208012,890,75,965,85.9300003052,16.1599998474,83.8399963379
170310208013,962,29,991,83.7699966431,20.4899997711,79.5100021362
170310208014,1384,110,1494,98.2200012207,19.4099998474,80.5899963379
170310208021,950,33,983,96.4700012207,10.0799999237,89.9199981689
170310208022,1601,0,1601,89.9400024414,16.7999992371,83.1999969482
170310208023,2334,0,2334,89.0500030518,0.0,100.0
170310208024,1487,0,1487,99.4000015259,0.0,100.0
170310209011,1722,153,1875,90.3199996948,7.01999998093,92.9800033569
170310209012,477,9,486,51.1599998474,30.0699996948,69.9300003052
170310209013,2043,65,2108,92.2900009155,5.48000001907,94.5199966431
170310209021,2058,143,2201,93.1399993896,23.2199993134,76.7799987793
170310209022,1470,0,1470,75.6600036621,0.0,100.0
170310301011,889,92,981,88.7799987793,17.3999996185,82.5999984741
170310301012,319,94,413,72.7099990845,23.9799995422,76.0199966431
170310301013,969,182,1151,100.0,0.0,0.0
170310301014,799,17,816,71.8300018311,31.6100006104,68.3899993896
170310301021,944,25,969,100.0,6.80000019073,93.1999969482
170310301022,996,0,996,95.1299972534,0.0,100.0
170310301023,1125,0,1125,82.0599975586,0.0,100.0
170310301031,804,0,804,94.2600021362,0.0,100.0
170310301032,952,44,996,100.0,47.0800018311,52.9199981689
170310301041,2496,99,2595,87.7900009155,14.6800003052,85.3199996948
170310301042,813,0,813,100.0,0.0,0.0
170310302001,1606,0,1606,91.7699966431,0.0,100.0
170310302002,934,24,958,72.5800018311,3.29999995232,96.6999969482
170310302003,641,70,711,69.1600036621,11.3699998856,88.6299972534
170310302004,1203,0,1203,92.6800003052,2.42000007629,97.5800018311
170310303001,1681,10,1691,100.0,9.84000015259,90.1600036621
170310303002,1520,54,1574,100.0,27.5300006866,72.4700012207
170310304001,1116,114,1230,89.6500015259,12.5699996948,87.4300003052
170310304002,838,41,879,67.0500030518,12.25,87.75
170310305001,1099,23,1122,97.2300033569,11.6800003052,88.3199996948
170310305002,1701,9,1710,87.7799987793,13.7399997711,86.2600021362
170310305003,1405,37,1442,90.3499984741,21.4899997711,78.5100021362
170310305004,1553,24,1577,96.3300018311,25.8199996948,74.1800003052
170310306011,1143,54,1197,100.0,0.0,0.0
170310306012,788,0,788,82.0800018311,6.42000007629,93.5800018311
170310306013,1514,31,1545,81.4899978638,18.6200008392,81.3799972534
170310306031,877,0,877,87.1800003052,4.96000003815,95.0400009155
170310306032,1177,0,1177,98.5800018311,20.9400005341,79.0599975586
170310306041,1081,0,1081,87.5299987793,8.02000045776,91.9800033569
170310306042,693,73,766,93.1900024414,23.5499992371,76.4499969482
170310306043,610,0,610,75.7799987793,7.84999990463,92.1500015259
170310307011,1546,0,1546,97.1100006104,1.58000004292,98.4199981689
170310307021,609,0,609,62.2700004578,0.0,100.0
170310307022,652,0,652,100.0,0.0,100.0
170310307031,908,0,908,87.4800033569,5.28000020981,94.7200012207
170310307032,442,0,442,86.8399963379,29.5,70.5
170310307033,1478,0,1478,96.5400009155,0.0,100.0
170310307061,2016,0,2016,100.0,36.4099998474,63.5900001526
170310307062,1353,0,1353,71.9700012207,23.0900001526,76.9100036621
170310308001,973,55,1028,100.0,33.5200004578,66.4800033569
170310308002,1094,41,1135,95.3000030518,0.0,100.0
170310308003,986,0,986,95.3600006104,0.0,100.0
170310308004,1047,0,1047,100.0,17.4899997711,82.5100021362
170310309001,433,14,447,79.2600021362,10.0500001907,89.9499969482
170310309002,670,27,697,78.4899978638,15.7600002289,84.2399978638
170310309003,714,92,806,89.8600006104,17.9500007629,82.0500030518
170310309004,681,0,681,96.4599990845,9.32999992371,90.6699981689
170310310001,926,0,926,94.5899963379,14.0500001907,85.9499969482
170310310002,1054,0,1054,100.0,13.2899999619,86.7099990845
170310310003,1336,55,1391,86.4000015259,8.77999973297,91.2200012207
170310311001,791,662,1453,76.3899993896,51.8300018311,48.1699981689
170310311002,826,21,847,87.2300033569,36.6199989319,63.3800010681
170310311003,1509,0,1509,98.4300003052,14.8199996948,85.1800003052
170310312001,1549,0,1549,97.0599975586,6.21000003815,93.7900009155
170310312002,1583,0,1583,95.8199996948,0.0,100.0
170310312003,1001,0,1001,93.7300033569,0.0,100.0
170310312004,1494,0,1494,100.0,2.00999999046,97.9899978638
170310313001,1366,68,1434,100.0,40.0200004578,59.9799995422
170310313002,514,750,1264,100.0,0.0,0.0
170310313003,656,0,656,94.5199966431,22.9599990845,77.0400009155
170310313004,2207,173,2380,100.0,38.6699981689,61.3300018311
170310313005,1182,160,1342,96.1299972534,69.1200027466,30.8799991608
170310314001,967,365,1332,100.0,0.0,0.0
170310314002,142,495,637,97.8499984741,0.0,0.0
170310314003,517,553,1070,99.7200012207,60.0699996948,39.9300003052
170310314004,116,0,116,100.0,58.4500007629,41.5499992371
170310314005,1067,11,1078,100.0,40.4300003052,59.5699996948
170310314006,901,0,901,100.0,37.7900009155,62.2099990845
170310315011,926,0,926,100.0,19.6200008392,80.3799972534
170310315012,1982,0,1982,100.0,6.11999988556,93.8799972534
170310315013,1171,0,1171,100.0,0.0,0.0
170310315021,1455,0,1455,100.0,2.02999997139,97.9700012207
170310315022,1118,0,1118,96.9599990845,7.92999982834,92.0699996948
170310315023,1668,51,1719,96.5199966431,0.0,100.0
170310317001,1805,202,2007,100.0,19.4699993134,80.5299987793
170310317002,1153,60,1213,64.4199981689,0.0,100.0
170310317003,891,246,1137,70.4899978638,0.219999998808,99.7799987793
170310317004,874,389,1263,99.5299987793,34.3800010681,65.6200027466
170310318001,1709,35,1744,95.1999969482,21.2000007629,78.8000030518
170310319001,938,112,1050,94.9400024414,38.4300003052,61.5699996948
170310319002,1148,9,1157,96.0199966431,30.2700004578,69.7300033569
170310321001,1623,64,1687,92.6900024414,21.8199996948,78.1800003052
170310321002,1149,0,1149,97.8700027466,32.6100006104,67.3899993896
170310321003,1586,136,1722,100.0,40.3699989319,59.6300010681
170310321004,1496,0,1496,100.0,3.55999994278,96.4400024414
170310321005,969,0,969,100.0,8.10000038147,91.9000015259
170310401001,443,121,564,38.4700012207,54.3300018311,45.6699981689
170310401002,1041,514,1555,100.0,44.8899993896,55.1100006104
170310401003,710,137,847,79.7600021362,12.0399999619,87.9599990845
170310402011,1229,0,1229,98.7900009155,7.86000013351,92.1399993896
170310402012,1586,160,1746,98.7600021362,21.5900001526,78.4100036621
170310402013,1402,66,1468,99.5899963379,26.4300003052,73.5699996948
170310402014,1258,435,1693,95.9800033569,36.6899986267,63.3100013733
170310402021,790,162,952,94.8199996948,27.25,72.75
170310402022,2299,374,2673,100.0,21.5300006866,78.4700012207
170310402023,1406,0,1406,98.3899993896,18.2199993134,81.7799987793
170310402024,2127,0,2127,99.5299987793,20.5799999237,79.4199981689
170310403001,453,447,900,86.2099990845,59.1100006104,40.8899993896
170310403002,1100,175,1275,98.9100036621,34.5699996948,65.4300003052
170310403003,406,352,758,96.4400024414,55.3699989319,44.6300010681
170310404011,686,103,789,91.2099990845,29.7600002289,70.2399978638
170310404012,586,0,586,95.4400024414,16.5599994659,83.4400024414
170310404013,570,46,616,98.5599975586,27.3999996185,72.5999984741
170310404014,659,126,785,80.5999984741,31.1100006104,68.8899993896
170310404021,609,78,687,100.0,21.3199996948,78.6800003052
170310404022,534,43,577,91.8799972534,75.6999969482,24.2999992371
170310404023,1154,87,1241,100.0,29.2800006866,70.7200012207
170310404024,481,116,597,88.8399963379,49.7299995422,50.2700004578
170310404025,1097,146,1243,98.2600021362,0.0,100.0
170310406001,526,58,584,93.7399978638,52.7200012207,47.2799987793
170310406002,906,103,1009,100.0,8.02000045776,91.9800033569
170310406003,780,23,803,95.3700027466,9.76000022888,90.2399978638
170310407001,758,30,788,100.0,3.76999998093,96.2300033569
170310407002,678,27,705,86.4000015259,20.2099990845,79.7900009155
170310407003,709,0,709,82.1600036621,0.0,100.0
170310407004,642,7,649,100.0,8.42000007629,91.5800018311
170310408001,721,0,721,97.4300003052,10.9499998093,89.0500030518
170310408002,509,44,553,74.3300018311,15.1599998474,84.8399963379
170310409001,1045,176,1221,99.6699981689,38.4099998474,61.5900001526
170310409002,636,78,714,94.6900024414,62.6500015259,37.3499984741
170310501001,611,150,761,100.0,13.0500001907,86.9499969482
170310501002,1458,34,1492,100.0,28.2299995422,71.7699966431
170310502001,951,0,951,100.0,23.3400001526,76.6600036621
170310502002,2080,16,2096,98.0400009155,24.9099998474,75.0899963379
170310502003,1624,95,1719,95.6600036621,12.8699998856,87.1299972534
170310503001,890,0,890,100.0,4.42999982834,95.5699996948
170310503002,731,0,731,100.0,11.720000267,88.2799987793
170310503003,497,49,546,69.1999969482,14.0,86.0
170310505001,916,0,916,98.2799987793,3.78999996185,96.2099990845
170310505002,1114,82,1196,85.0,26.4099998474,73.5899963379
170310505003,360,228,588,74.5199966431,60.4799995422,39.5200004578
170310505004,625,237,862,92.0899963379,51.9700012207,48.0299987793
170310505005,735,0,735,95.6999969482,26.3199996948,73.6800003052
170310506001,991,12,1003,95.6100006104,21.7399997711,78.2600021362
170310506002,1026,26,1052,100.0,31.7099990845,68.2900009155
170310507001,1280,138,1418,97.5899963379,52.2999992371,47.7000007629
170310508001,955,237,1192,93.0500030518,48.6899986267,51.3100013733
170310509001,1266,9,1275,90.0400009155,9.0,91.0
170310510001,1409,0,1409,90.2600021362,5.11000013351,94.8899993896
170310511001,1268,168,1436,94.0400009155,26.8099994659,73.1900024414
170310512001,574,110,684,97.7099990845,48.0900001526,51.9099998474
170310512002,748,77,825,100.0,14.8900003433,85.1100006104
170310513001,887,265,1152,95.2099990845,32.4799995422,67.5199966431
170310513002,1246,105,1351,93.1699981689,30.9300003052,69.0699996948
170310514001,1070,38,1108,96.9400024414,32.5999984741,67.4000015259
170310514002,936,28,964,96.2099990845,36.2200012207,63.7799987793
170310601001,696,38,734,100.0,19.4899997711,80.5100021362
170310601002,1077,19,1096,100.0,6.55999994278,93.4400024414
170310601003,630,42,672,93.9899978638,44.0600013733,55.9399986267
170310602001,931,57,988,89.4899978638,24.8999996185,75.0999984741
170310602002,873,108,981,91.1699981689,26.1599998474,73.8399963379
170310603001,1390,47,1437,96.0599975586,14.779999733,85.2200012207
170310603002,1338,0,1338,99.8499984741,7.84000015259,92.1600036621
170310604001,1256,22,1278,87.4100036621,9.5,90.5
170310604002,849,89,938,100.0,59.5200004578,40.4799995422
170310604003,876,63,939,89.8600006104,24.1200008392,75.8799972534
170310605001,1266,43,1309,100.0,59.1199989319,40.8800010681
170310608001,1388,0,1388,95.0699996948,11.3199996948,88.6800003052
170310608002,-99999,-99999,-99999,-99999.0,64.25,35.75
170310608003,3164,0,3164,95.3899993896,42.7099990845,57.2900009155
170310609001,1066,68,1134,88.7300033569,7.38000011444,92.6200027466
170310609002,-99999,-99999,-99999,-99999.0,50.3899993896,49.6100006104
170310609003,1120,211,1331,100.0,72.8199996948,27.1800003052
170310609004,3503,0,3503,100.0,14.0500001907,85.9499969482
170310609005,883,0,883,100.0,0.0,0.0
170310610001,1498,0,1498,93.4499969482,7.67000007629,92.3300018311
170310611001,882,0,882,65.0,3.41000008583,96.5899963379
170310612001,1633,112,1745,90.7900009155,23.2399997711,76.7600021362
170310615001,1566,84,1650,95.3799972534,26.5,73.5
170310618001,1110,0,1110,91.2799987793,25.2900009155,74.7099990845
170310619011,725,14,739,100.0,36.7999992371,63.2000007629
170310619012,126,662,788,95.8600006104,0.0,0.0
170310619013,636,126,762,95.4899978638,0.0,0.0
170310619014,1076,0,1076,92.4400024414,28.75,71.25
170310619021,1084,0,1084,100.0,16.7700004578,83.2300033569
170310619022,1579,23,1602,100.0,15.1199998856,84.8799972534
170310619023,1423,51,1474,100.0,43.6300010681,56.3699989319
170310619024,-99999,-99999,-99999,-99999.0,0.0,0.0
170310620001,1685,0,1685,92.1299972534,11.5399999619,88.4599990845
170310620002,769,30,799,96.1500015259,18.3500003815,81.6500015259
170310621001,811,0,811,98.5400009155,0.0,100.0
170310621002,1085,0,1085,100.0,0.0,100.0
170310621003,1521,0,1521,100.0,7.19999980927,92.8000030518
170310622001,1450,0,1450,100.0,0.0,100.0
170310622002,1409,11,1420,99.8600006104,20.0100002289,79.9899978638
170310623001,1415,0,1415,93.2099990845,10.3599996567,89.6399993896
170310624001,1300,0,1300,89.2900009155,15.4499998093,84.5500030518
170310625001,1449,0,1449,98.4400024414,0.219999998808,99.7799987793
170310626001,1911,85,1996,90.0299987793,13.5799999237,86.4199981689
170310627001,799,0,799,97.9199981689,4.90000009537,95.0999984741
170310627002,809,17,826,96.0500030518,41.5699996948,58.4300003052
170310627003,1039,28,1067,100.0,4.65000009537,95.3499984741
170310628001,1056,0,1056,96.9700012207,25.3099994659,74.6900024414
170310628002,1067,0,1067,98.5199966431,20.8700008392,79.1299972534
170310628003,1373,0,1373,100.0,4.82000017166,95.1800003052
170310629001,936,138,1074,83.4499969482,0.0,100.0
170310629002,976,173,1149,100.0,28.8400001526,71.1600036621
170310629003,1215,311,1526,100.0,49.8699989319,50.1300010681
170310630001,1087,0,1087,98.0199966431,0.0,100.0
170310630002,1219,4,1223,100.0,12.0100002289,87.9899978638
170310630003,550,0,550,74.2200012207,0.0,100.0
170310631001,1150,0,1150,100.0,1.76999998093,98.2300033569
170310631002,982,0,982,94.7900009155,19.6900005341,80.3099975586
170310632001,953,119,1072,100.0,7.53999996185,92.4599990845
170310632002,478,0,478,88.5199966431,23.5499992371,76.4499969482
170310632003,947,0,947,90.7099990845,5.21999979019,94.7799987793
170310632004,979,251,1230,95.2699966431,41.0900001526,58.9099998474
170310632005,834,0,834,100.0,36.3400001526,63.6599998474
170310632006,1397,50,1447,84.0800018311,0.0,0.0
170310633011,1042,0,1042,94.3000030518,0.0,0.0
170310633012,598,187,785,100.0,0.0,0.0
170310633013,798,0,798,100.0,0.0,100.0
170310633021,1291,165,1456,95.3499984741,17.1599998474,82.8399963379
170310633022,845,0,845,100.0,48.0900001526,51.9099998474
170310633023,689,0,689,88.9000015259,13.3900003433,86.6100006104
170310633024,151,696,847,83.9400024414,100.0,0.0
170310633031,416,12,428,100.0,87.6600036621,12.3400001526
170310633032,773,0,773,100.0,53.6300010681,46.3699989319
170310634001,1169,0,1169,95.4300003052,0.0900000035763,99.9100036621
170310634002,993,18,1011,100.0,4.26000022888,95.7399978638
170310701011,1367,0,1367,100.0,0.0,0.0
170310701012,1235,0,1235,100.0,10.75,89.25
170310701013,1093,82,1175,93.6299972534,61.6500015259,38.3499984741
170310701021,1043,0,1043,85.4199981689,0.0,100.0
170310701022,596,0,596,100.0,0.0,100.0
170310701023,774,0,774,98.7200012207,0.0,0.0
170310701031,636,159,795,100.0,67.1999969482,32.7999992371
170310701032,884,0,884,100.0,3.09999990463,96.9000015259
170310702001,1766,0,1766,100.0,2.67000007629,97.3300018311
170310702002,1080,10,1090,97.3199996948,41.1699981689,58.8300018311
170310702003,1018,0,1018,94.9599990845,0.0,100.0
170310703001,1826,29,1855,95.9599990845,11.0699996948,88.9300003052
170310703002,1512,0,1512,100.0,19.2800006866,80.7200012207
170310704001,1142,9,1151,99.4800033569,10.1700000763,89.8300018311
170310704002,857,0,857,100.0,8.56000041962,91.4400024414
170310704003,941,24,965,98.3700027466,38.0499992371,61.9500007629
170310705001,813,123,936,100.0,37.3199996948,62.6800003052
170310705002,1048,0,1048,98.3099975586,9.71000003815,90.2900009155
170310705003,748,89,837,87.9199981689,10.3900003433,89.6100006104
170310706001,1576,88,1664,95.6900024414,17.25,82.75
170310706002,1026,24,1050,81.8399963379,7.88999986649,92.1100006104
170310707001,2341,40,2381,98.4300003052,16.7299995422,83.2699966431
170310707002,1047,9,1056,96.2600021362,12.5,87.5
170310710001,2084,509,2593,100.0,46.5900001526,53.4099998474
170310710002,1617,90,1707,96.5500030518,20.2800006866,79.7200012207
170310711001,1619,23,1642,99.3899993896,34.5099983215,65.4899978638
170310711002,1071,103,1174,92.3000030518,8.06999969482,91.9300003052
170310712001,902,0,902,99.2300033569,13.3100004196,86.6900024414
170310712002,810,192,1002,100.0,34.2999992371,65.6999969482
170310713001,1683,47,1730,95.0,19.3299999237,80.6699981689
170310713002,1612,171,1783,99.5500030518,56.7099990845,43.2900009155
170310714001,796,13,809,100.0,39.2299995422,60.7700004578
170310714002,1545,108,1653,100.0,36.6399993896,63.3600006104
170310714003,1333,134,1467,100.0,9.92000007629,90.0800018311
170310714004,570,25,595,100.0,52.0900001526,47.9099998474
170310715001,1100,0,1100,95.7399978638,0.0,100.0
170310715002,1041,0,1041,100.0,50.4099998474,49.5900001526
170310715003,235,12,247,19.1499996185,48.2900009155,51.7099990845
170310715004,902,113,1015,90.3000030518,17.8600006104,82.1399993896
170310715005,621,0,621,99.3600006104,13.3699998856,86.6299972534
170310715006,191,24,215,34.2900009155,9.89000034332,90.1100006104
170310716001,1185,226,1411,79.6299972534,26.5799999237,73.4199981689
170310717001,60,314,374,52.3800010681,0.0,0.0
170310717002,335,573,908,100.0,77.4899978638,22.5100002289
170310718001,1842,78,1920,88.4400024414,30.6200008392,69.3799972534
170310718002,535,0,535,96.0500030518,7.07000017166,92.9300003052
170310801001,504,0,504,97.8600006104,0.0,100.0
170310801002,1053,0,1053,100.0,23.4599990845,76.5400009155
170310801003,870,75,945,100.0,0.0,100.0
170310801004,851,251,1102,100.0,53.4799995422,46.5200004578
170310801005,706,368,1074,100.0,21.0,79.0
170310801006,669,120,789,95.75,0.0,0.0
170310801007,546,0,546,100.0,48.4700012207,51.5299987793
170310802011,371,899,1270,83.0599975586,67.5400009155,32.4599990845
170310802012,1273,113,1386,100.0,0.0,100.0
170310802013,251,271,522,90.7799987793,0.0,0.0
170310802021,464,0,464,74.2399978638,6.44000005722,93.5599975586
170310802022,768,424,1192,89.2900009155,68.4700012207,31.5300006866
170310802023,1461,268,1729,100.0,0.0,100.0
170310803001,324,253,577,78.9300003052,71.8399963379,28.1599998474
170310803002,1678,0,1678,100.0,11.9399995804,88.0599975586
170310803003,691,0,691,80.0699996948,0.0,100.0
170310803004,1002,0,1002,90.6800003052,17.2399997711,82.7600021362
170310804001,1902,98,2000,79.6500015259,0.0,100.0
170310804002,579,0,579,100.0,9.11999988556,90.8799972534
170310804003,1105,43,1148,94.25,5.78000020981,94.2200012207
170310810001,376,0,376,70.5400009155,47.25,52.75
170310810002,1172,4,1176,82.3499984741,16.3400001526,83.6600036621
170310810003,930,120,1050,100.0,39.4500007629,60.5499992371
170310810004,1363,0,1363,100.0,18.7099990845,81.2900009155
170310810005,1692,190,1882,83.2399978638,37.1399993896,62.8600006104
170310810006,1302,0,1302,100.0,20.5200004578,79.4800033569
170310811001,1028,23,1051,92.8399963379,7.30000019073,92.6999969482
170310811002,1158,0,1158,97.5599975586,0.0,100.0
170310811003,1431,0,1431,100.0,0.0,100.0
170310812011,675,0,675,79.4100036621,0.0,100.0
170310812012,2084,0,2084,100.0,18.9599990845,81.0400009155
170310812013,1094,0,1094,100.0,4.19999980927,95.8000030518
170310812021,557,0,557,97.2099990845,45.1599998474,54.8400001526
170310812022,734,21,755,92.6399993896,39.8199996948,60.1800003052
170310812023,814,0,814,100.0,19.5400009155,80.4599990845
170310812024,717,0,717,93.8499984741,20.4500007629,79.5500030518
170310813001,772,0,772,82.5699996948,0.0,0.0
170310813002,544,0,544,100.0,0.0,100.0
170310813003,696,0,696,87.7699966431,0.0,100.0
170310813004,1556,0,1556,100.0,35.0800018311,64.9199981689
170310813005,607,0,607,100.0,0.0,0.0
170310813006,624,0,624,100.0,42.0400009155,57.9599990845
170310814011,937,32,969,98.5800018311,11.5600004196,88.4400024414
170310814012,1293,3,1296,97.2200012207,29.1200008392,70.8799972534
170310814021,1249,472,1721,88.0800018311,23.1299991608,76.8700027466
170310814022,1477,0,1477,100.0,0.0,100.0
170310814023,410,0,410,53.25,0.0,100.0
170310814031,1418,0,1418,50.6399993896,13.4300003052,86.5699996948
170310814032,1259,0,1259,85.2399978638,0.0,100.0
170310814033,518,0,518,26.4599990845,0.0,100.0
170310815001,1309,0,1309,98.0500030518,8.89999961853,91.0999984741
170310815002,1458,0,1458,99.5199966431,1.79999995232,98.1999969482
170310815003,1376,0,1376,92.3499984741,3.01999998093,96.9800033569
170310816001,1315,0,1315,52.4500007629,0.0,100.0
170310816002,904,0,904,100.0,26.3700008392,73.6299972534
170310817001,1245,0,1245,98.8099975586,0.0,100.0
170310817002,1193,0,1193,65.6900024414,7.19000005722,92.8099975586
170310818001,2988,158,3146,98.1900024414,7.59000015259,92.4100036621
170310818002,1114,0,1114,51.1199989319,2.74000000954,97.2600021362
170310818003,1372,0,1372,88.5699996948,1.72000002861,98.2799987793
170310819001,531,321,852,82.2399978638,42.6300010681,57.3699989319
170310901001,650,190,840,86.1500015259,32.8199996948,67.1800003052
170310901002,723,47,770,86.0299987793,14.6300001144,85.3700027466
170310901003,311,191,502,73.0699996948,39.5200004578,60.4799995422
170310901004,349,276,625,75.1200027466,53.5,46.5
170310902001,546,201,747,79.9800033569,43.3100013733,56.6899986267
170310902002,782,316,1098,85.6500015259,44.3800010681,55.6199989319
170310902003,1258,210,1468,99.0599975586,25.0,75.0
170310902004,1140,608,1748,90.5699996948,42.8199996948,57.1800003052
170310902005,248,263,511,54.5900001526,63.6899986267,36.3100013733
170310903001,890,465,1355,98.2600021362,63.2999992371,36.7000007629
170311001001,1179,23,1202,96.2399978638,17.8500003815,82.1500015259
170311001002,1503,63,1566,97.8799972534,12.8100004196,87.1900024414
170311001003,775,68,843,99.6500015259,50.0299987793,49.9700012207
170311001004,277,74,351,67.8899993896,37.2099990845,62.7900009155
170311001005,1025,39,1064,97.2600021362,21.6900005341,78.3099975586
170311002001,890,197,1087,98.2799987793,67.5400009155,32.4599990845
170311002002,653,76,729,89.2300033569,33.0999984741,66.9000015259
170311002003,926,75,1001,85.4100036621,23.0,77.0
170311002004,784,102,886,97.1500015259,11.3299999237,88.6699981689
170311002005,1046,46,1092,98.2900009155,19.0699996948,80.9300003052
170311002006,580,216,796,89.4400024414,43.5600013733,56.4399986267
170311002007,505,160,665,88.6699981689,29.5599994659,70.4400024414
170311003001,722,289,1011,90.3499984741,54.6500015259,45.3499984741
170311003002,1219,76,1295,95.8499984741,26.4300003052,73.5699996948
170311003003,221,138,359,51.4300003052,0.0,0.0
170311003004,840,216,1056,97.2399978638,48.4500007629,51.5499992371
170311003005,662,144,806,89.1600036621,47.6100006104,52.3899993896
170311003006,512,263,775,77.8899993896,55.9700012207,44.0299987793
170311004001,723,110,833,100.0,58.0400009155,41.9599990845
170311004002,596,295,891,100.0,58.75,41.25
170311004003,1086,238,1324,98.2900009155,46.2200012207,53.7799987793
170311005001,813,60,873,88.9000015259,13.9099998474,86.0899963379
170311005002,640,43,683,98.8399963379,14.5799999237,85.4199981689
170311005003,354,48,402,42.9900016785,0.0,0.0
170311005004,818,332,1150,85.6900024414,57.3600006104,42.6399993896
170311005005,1156,307,1463,80.5199966431,42.1599998474,57.8400001526
170311006001,1019,6,1025,97.9000015259,12.4499998093,87.5500030518
170311006002,909,133,1042,100.0,30.3099994659,69.6900024414
170311006003,1058,78,1136,98.6999969482,11.3299999237,88.6699981689
170311006004,1378,193,1571,95.8499984741,25.9799995422,74.0199966431
170311007001,840,11,851,97.5899963379,17.0300006866,82.9700012207
170311007002,637,78,715,78.8300018311,34.9799995422,65.0199966431
170311007003,518,175,693,73.2600021362,30.2000007629,69.8000030518
170311007004,539,119,658,72.7099990845,29.6700000763,70.3300018311
170311007005,936,222,1158,93.9199981689,28.0699996948,71.9300003052
170311101001,832,72,904,68.4800033569,20.3899993896,79.6100006104
170311101002,993,52,1045,91.9899978638,26.4899997711,73.5100021362
170311101003,593,11,604,99.0199966431,20.1299991608,79.8700027466
170311101004,997,22,1019,98.7399978638,12.8000001907,87.1999969482
170311101005,908,109,1017,90.4800033569,51.6500015259,48.3499984741
170311102001,1577,5,1582,97.4700012207,16.25,83.75
170311102002,1222,0,1222,100.0,16.5100002289,83.4899978638
170311103001,684,23,707,98.1900024414,40.6399993896,59.3600006104
170311103002,935,100,1035,100.0,23.4599990845,76.5400009155
170311103003,691,36,727,99.0500030518,39.2900009155,60.7099990845
170311103004,967,297,1264,93.6999969482,48.0400009155,51.9599990845
170311103005,1172,148,1320,100.0,38.2900009155,61.7099990845
170311104001,1549,62,1611,93.0699996948,47.5699996948,52.4300003052
170311104002,1319,23,1342,97.3199996948,30.1499996185,69.8499984741
170311104003,1223,96,1319,100.0,29.3799991608,70.6200027466
170311105011,887,178,1065,90.9499969482,28.7000007629,71.3000030518
170311105012,769,54,823,98.6800003052,14.5100002289,85.4899978638
170311105013,1454,168,1622,100.0,23.6499996185,76.3499984741
170311105014,305,29,334,92.2699966431,31.4099998474,68.5899963379
170311105015,635,18,653,100.0,2.8900001049,97.1100006104
170311105021,1412,34,1446,99.4499969482,29.25,70.75
170311105022,1096,297,1393,80.6600036621,47.6500015259,52.3499984741
170311201001,699,484,1183,82.9599990845,57.0800018311,42.9199981689
170311201002,235,667,902,98.0400009155,63.3100013733,36.6899986267
170311201003,157,460,617,76.6500015259,94.0999984741,5.90000009537
170311201004,549,387,936,91.8499984741,59.4000015259,40.5999984741
170311202001,1011,422,1433,88.5699996948,44.7200012207,55.2799987793
170311202002,567,239,806,93.7200012207,45.2200012207,54.7799987793
170311202003,341,487,828,98.4499969482,62.2200012207,37.7799987793
170311202004,599,387,986,85.2900009155,56.0299987793,43.9700012207
170311203001,626,266,892,87.1900024414,30.7099990845,69.2900009155
170311203002,633,385,1018,85.4700012207,51.8100013733,48.1899986267
170311203003,148,315,463,33.8899993896,59.6800003052,40.3199996948
170311203004,522,352,874,98.8700027466,60.2299995422,39.7700004578
170311203005,362,365,727,79.1900024414,57.7999992371,42.2000007629
170311203006,413,351,764,79.5800018311,54.2000007629,45.7999992371
170311204001,564,204,768,86.4899978638,36.2799987793,63.7200012207
170311204002,982,38,1020,92.6399993896,20.8899993896,79.1100006104
170311204003,1331,71,1402,94.7900009155,28.2999992371,71.6999969482
170311301001,790,276,1066,86.8099975586,52.0900001526,47.9099998474
170311301002,892,741,1633,83.8300018311,84.1800003052,15.8199996948
170311301003,1598,172,1770,91.8000030518,9.28999996185,90.7099990845
170311302001,557,234,791,52.4900016785,65.1200027466,34.8800010681
170311303001,642,25,667,100.0,39.5499992371,60.4500007629
170311303002,280,305,585,68.0199966431,57.4099998474,42.5900001526
170311303003,1558,93,1651,90.3199996948,34.7799987793,65.2200012207
170311303004,1223,163,1386,79.75,18.5,81.5
170311401001,1294,146,1440,90.2799987793,23.75,76.25
170311401002,2085,0,2085,98.3000030518,5.67999982834,94.3199996948
170311402001,1897,216,2113,93.9100036621,21.5799999237,78.4199981689
170311402002,1367,63,1430,100.0,21.5400009155,78.4599990845
170311402003,1459,75,1534,69.4100036621,3.93000006676,96.0699996948
170311403011,1248,83,1331,99.1100006104,8.64000034332,91.3600006104
170311403012,1520,40,1560,100.0,5.09000015259,94.9100036621
170311403021,785,29,814,87.6200027466,13.4200000763,86.5800018311
170311403022,526,233,759,46.8199996948,100.0,0.0
170311403023,1318,238,1556,86.7300033569,41.0200004578,58.9799995422
170311404001,1298,48,1346,91.1299972534,5.86999988556,94.1299972534
170311404002,626,247,873,76.0500030518,36.0900001526,63.9099998474
170311404003,641,119,760,74.9499969482,22.0200004578,77.9800033569
170311404004,996,107,1103,84.0100021362,26.2199993134,73.7799987793
170311404005,1628,185,1813,95.5699996948,29.9200000763,70.0800018311
170311405001,1086,14,1100,100.0,19.25,80.75
170311405002,1147,0,1147,98.9599990845,3.33999991417,96.6600036621
170311405003,1402,0,1402,99.1500015259,0.0,100.0
170311406011,2674,11,2685,94.5100021362,7.28999996185,92.7099990845
170311406021,1066,0,1066,100.0,6.92000007629,93.0800018311
170311406022,1116,38,1154,59.5499992371,6.01999998093,93.9800033569
170311406023,1006,0,1006,66.4499969482,0.0,100.0
170311406024,879,105,984,98.0100021362,10.7899999619,89.2099990845
170311407011,1315,94,1409,94.25,3.16000008583,96.8399963379
170311407012,1372,66,1438,99.3099975586,4.92999982834,95.0699996948
170311407021,1552,29,1581,100.0,15.6499996185,84.3499984741
170311407022,1229,13,1242,78.8600006104,4.55000019073,95.4499969482
170311407023,1009,0,1009,64.5100021362,0.0,100.0
170311407024,933,166,1099,78.4400024414,14.6800003052,85.3199996948
170311408001,1037,106,1143,92.1800003052,8.39999961853,91.5999984741
170311408002,644,6,650,90.6600036621,7.19000005722,92.8099975586
170311408003,1025,0,1025,87.7600021362,0.0,100.0
170311408004,1400,0,1400,96.8199996948,5.88999986649,94.1100006104
170311408005,1950,59,2009,88.6200027466,4.01999998093,95.9800033569
170311502001,1189,61,1250,99.4400024414,23.1100006104,76.8899993896
170311502002,1487,21,1508,98.6299972534,41.9099998474,58.0900001526
170311502003,1313,34,1347,100.0,10.1499996185,89.8499984741
170311502004,1738,192,1930,99.9000015259,35.75,64.25
170311502005,1414,22,1436,100.0,20.8999996185,79.0999984741
170311503001,701,244,945,92.9199981689,15.8900003433,84.1100006104
170311503002,1019,353,1372,100.0,45.1199989319,54.8800010681
170311503003,583,267,850,98.1500015259,64.4899978638,35.5099983215
170311503004,830,79,909,91.3600006104,21.1499996185,78.8499984741
170311503005,638,11,649,83.6299972534,59.2799987793,40.7200012207
170311503006,834,156,990,96.4000015259,14.4600000381,85.5400009155
170311503007,989,86,1075,90.2600021362,17.0799999237,82.9199981689
170311504011,1147,18,1165,100.0,17.3999996185,82.5999984741
170311504012,1096,85,1181,91.4800033569,22.3700008392,77.6299972534
170311504013,998,193,1191,93.0500030518,19.5200004578,80.4800033569
170311504014,772,203,975,90.3600006104,33.75,66.25
170311504021,751,45,796,94.6500015259,15.3500003815,84.6500015259
170311504022,935,172,1107,93.0999984741,29.1599998474,70.8399963379
170311504023,1547,213,1760,95.5,17.7399997711,82.2600021362
170311505011,1244,131,1375,93.1600036621,10.220000267,89.7799987793
170311505012,406,167,573,70.4800033569,68.75,31.25
170311505013,1318,40,1358,99.8499984741,18.0100002289,81.9899978638
170311505021,1399,75,1474,90.8799972534,20.9099998474,79.0899963379
170311505022,1073,162,1235,100.0,22.7000007629,77.3000030518
170311505023,1096,94,1190,86.6699981689,22.8099994659,77.1900024414
170311506001,1042,12,1054,89.7799987793,7.32000017166,92.6800003052
170311506002,704,165,869,94.0500030518,28.7700004578,71.2300033569
170311506003,917,179,1096,93.9199981689,34.9500007629,65.0500030518
170311506004,713,115,828,93.0299987793,29.0799999237,70.9199981689
170311507001,1002,54,1056,93.2900009155,28.5900001526,71.4100036621
170311507002,997,86,1083,92.3300018311,26.8999996185,73.0999984741
170311507003,849,80,929,89.2399978638,25.5599994659,74.4400024414
170311507004,1139,57,1196,92.7099990845,17.5499992371,82.4499969482
170311508001,862,0,862,97.7300033569,0.449999988079,99.5500030518
170311508002,774,54,828,85.0100021362,0.0,100.0
170311508003,1266,126,1392,100.0,24.7000007629,75.3000030518
170311508004,858,85,943,82.9400024414,16.6299991608,83.3700027466
170311508005,880,0,880,100.0,14.4499998093,85.5500030518
170311510011,1612,184,1796,90.75,18.9400005341,81.0599975586
170311510012,724,78,802,93.9100036621,33.4500007629,66.5500030518
170311510021,1221,0,1221,94.7200012207,0.0,100.0
170311510022,998,19,1017,99.4100036621,12.9200000763,87.0800018311
170311510023,1423,23,1446,94.2600021362,10.1499996185,89.8499984741
170311510024,655,0,655,100.0,0.0,100.0
170311511001,1455,88,1543,91.6299972534,24.8199996948,75.1800003052
170311511002,1401,35,1436,99.3099975586,9.02000045776,90.9800033569
170311511003,1095,14,1109,91.6500015259,3.05999994278,96.9400024414
170311511004,1151,17,1168,100.0,15.1899995804,84.8099975586
170311512001,1074,41,1115,88.5599975586,13.8599996567,86.1399993896
170311512002,1247,12,1259,100.0,10.6300001144,89.3700027466
170311512003,1098,114,1212,88.2099990845,26.2999992371,73.6999969482
170311601001,871,113,984,60.2200012207,63.5400009155,36.4599990845
170311601002,744,81,825,94.6100006104,70.5400009155,29.4599990845
170311602001,637,0,637,86.6699981689,21.3899993896,78.6100006104
170311602002,536,0,536,91.1600036621,50.25,49.75
170311602003,513,74,587,94.3700027466,37.3899993896,62.6100006104
170311602004,1248,92,1340,88.0400009155,25.9099998474,74.0899963379
170311603001,1768,91,1859,98.3600006104,8.68999958038,91.3099975586
170311603002,754,54,808,90.3799972534,40.1500015259,59.8499984741
170311603003,798,178,976,95.3099975586,69.9300003052,30.0699996948
170311604001,2069,90,2159,90.4899978638,8.23999977112,91.7600021362
170311604002,1401,23,1424,98.4800033569,10.4399995804,89.5599975586
170311604003,977,17,994,100.0,15.529999733,84.4700012207
170311605011,1918,0,1918,91.9499969482,3.55999994278,96.4400024414
170311605012,1222,307,1529,74.9899978638,25.3500003815,74.6500015259
170311605021,387,9,396,48.8300018311,0.0,0.0
170311605022,1373,0,1373,98.4899978638,3.0,97.0
170311605023,1127,47,1174,88.5999984741,8.85999965668,91.1399993896
170311606011,1571,0,1571,99.4300003052,3.63000011444,96.3700027466
170311606012,631,8,639,89.3700027466,11.8199996948,88.1800003052
170311606013,1084,101,1185,100.0,55.4000015259,44.5999984741
170311606021,1047,0,1047,99.2399978638,0.0,100.0
170311606022,1138,0,1138,98.9599990845,12.1300001144,87.8700027466
170311606023,1100,121,1221,87.8399963379,55.2799987793,44.7200012207
170311607001,735,68,803,100.0,52.9300003052,47.0699996948
170311607002,779,0,779,79.4899978638,2.96000003815,97.0400009155
170311607003,1275,268,1543,88.8799972534,32.6100006104,67.3899993896
170311607004,1190,0,1190,96.3600006104,6.26999998093,93.7300033569
170311607005,1107,0,1107,98.3099975586,5.5,94.5
170311608001,1179,28,1207,100.0,20.6800003052,79.3199996948
170311608002,545,0,545,65.5800018311,18.4099998474,81.5899963379
170311608003,862,76,938,98.9499969482,28.9099998474,71.0899963379
170311608004,739,32,771,93.6800003052,22.8999996185,77.0999984741
170311608005,1349,0,1349,100.0,1.75,98.25
170311609001,1161,247,1408,97.3700027466,36.3600006104,63.6399993896
170311609002,908,51,959,98.5599975586,38.1399993896,61.8600006104
170311610001,642,66,708,94.9100036621,53.2599983215,46.7400016785
170311610002,783,167,950,96.3499984741,56.0999984741,43.9000015259
170311611001,851,104,955,98.5599975586,60.9199981689,39.0800018311
170311611002,787,88,875,96.6900024414,25.5400009155,74.4599990845
170311612001,1015,5,1020,81.4700012207,11.9600000381,88.0400009155
170311612002,1147,134,1281,75.0899963379,11.1300001144,88.8700027466
170311613001,654,0,654,98.9400024414,18.4200000763,81.5800018311
170311613002,1122,0,1122,100.0,1.66999995708,98.3300018311
170311613003,977,48,1025,93.7799987793,5.30999994278,94.6900024414
170311613004,1035,38,1073,82.0999984741,14.5100002289,85.4899978638
170311701001,1400,209,1609,90.6500015259,26.0599994659,73.9400024414
170311702001,935,98,1033,88.2900009155,24.3899993896,75.6100006104
170311702002,1354,173,1527,99.2799987793,27.4699993134,72.5299987793
170311702003,978,57,1035,87.6399993896,43.4199981689,56.5800018311
170311703001,745,68,813,95.9899978638,40.5699996948,59.4300003052
170311703002,886,63,949,100.0,33.3499984741,66.6500015259
170311703003,677,90,767,86.6699981689,33.0900001526,66.9100036621
170311703004,528,217,745,74.8000030518,41.7099990845,58.2900009155
170311703005,1434,19,1453,98.9100036621,12.0,88.0
170311704001,781,48,829,96.4000015259,12.6499996185,87.3499984741
170311704002,876,20,896,95.0199966431,22.3999996185,77.5999984741
170311704003,901,157,1058,98.6900024414,12.1000003815,87.9000015259
170311704004,889,87,976,97.3099975586,41.7200012207,58.2799987793
170311705001,1241,210,1451,86.2699966431,33.5600013733,66.4400024414
170311705002,431,193,624,91.5,48.0099983215,51.9900016785
170311705003,817,264,1081,79.8399963379,33.6199989319,66.3799972534
170311705004,1019,145,1164,89.3300018311,39.0699996948,60.9300003052
170311706001,480,422,902,94.4499969482,51.8899993896,48.1100006104
170311706002,1256,262,1518,98.7600021362,42.8800010681,57.1199989319
170311707001,469,146,615,64.3300018311,52.6399993896,47.3600006104
170311707002,436,312,748,84.8099975586,45.8400001526,54.1599998474
170311707003,431,397,828,72.6299972534,60.4199981689,39.5800018311
170311708001,1215,0,1215,100.0,17.5400009155,82.4599990845
170311708002,857,143,1000,81.8300018311,18.9500007629,81.0500030518
170311708003,845,135,980,77.4100036621,16.8700008392,83.1299972534
170311709001,1399,73,1472,85.3799972534,11.0100002289,88.9899978638
170311710001,1188,94,1282,93.2399978638,19.5400009155,80.4599990845
170311710002,1225,90,1315,93.6600036621,14.8599996567,85.1399993896
170311710003,824,136,960,100.0,35.6699981689,64.3300018311
170311710004,792,303,1095,97.6800003052,54.4700012207,45.5299987793
170311710005,922,132,1054,85.0,25.8299999237,74.1699981689
170311710006,1168,11,1179,97.5199966431,6.82999992371,93.1699981689
170311711001,1124,78,1202,88.3199996948,20.5400009155,79.4599990845
170311711002,1273,128,1401,91.6900024414,7.55999994278,92.4400024414
170311711003,1079,130,1209,97.5800018311,24.1399993896,75.8600006104
170311801001,762,175,937,94.3600006104,41.2200012207,58.7799987793
170311801002,819,258,1077,83.8099975586,44.0200004578,55.9799995422
170311801003,937,298,1235,86.3000030518,28.2900009155,71.7099990845
170311801004,843,201,1044,87.0,6.32000017166,93.6800003052
170311801005,1269,93,1362,100.0,12.0100002289,87.9899978638
170311901001,2479,0,2479,100.0,9.72000026703,90.2799987793
170311902001,1298,0,1298,100.0,5.13000011444,94.8700027466
170311902002,1362,37,1399,89.3399963379,20.6299991608,79.3700027466
170311902003,1307,128,1435,89.8600006104,17.6900005341,82.3099975586
170311902004,1312,59,1371,100.0,6.59999990463,93.4000015259
170311903001,1352,0,1352,98.2600021362,4.26999998093,95.7300033569
170311903002,1336,42,1378,85.9100036621,14.6800003052,85.3199996948
170311903003,1237,103,1340,84.1699981689,16.2299995422,83.7699966431
170311903004,1232,41,1273,99.9199981689,21.6499996185,78.3499984741
170311904011,1540,26,1566,97.75,16.7800006866,83.2200012207
170311904012,2176,299,2475,91.5599975586,15.8500003815,84.1500015259
170311904021,2166,7,2173,94.7300033569,4.96000003815,95.0400009155
170311904022,2862,50,2912,94.2399978638,14.1899995804,85.8099975586
170311906011,1142,25,1167,100.0,10.1400003433,89.8600006104
170311906012,891,146,1037,84.3099975586,64.9000015259,35.0999984741
170311906013,1971,183,2154,98.9000015259,24.8199996948,75.1800003052
170311906021,1209,146,1355,100.0,16.5699996948,83.4300003052
170311906022,1744,211,1955,92.2600021362,15.4899997711,84.5100021362
170311906023,1606,169,1775,88.0899963379,17.8700008392,82.1299972534
170311907011,1505,0,1505,94.5400009155,6.30999994278,93.6900024414
170311907012,1294,0,1294,93.9000015259,6.94999980927,93.0500030518
170311907021,1089,73,1162,82.4700012207,8.36999988556,91.6299972534
170311907022,964,267,1231,85.4899978638,15.2299995422,84.7699966431
170311907023,1713,269,1982,97.25,23.8199996948,76.1800003052
170311908001,947,0,947,97.5299987793,0.0599999986589,99.9400024414
170311908002,1000,0,1000,84.25,0.0,100.0
170311908003,1518,0,1518,100.0,9.92000007629,90.0800018311
170311908004,1218,56,1274,83.3799972534,12.7100000381,87.2900009155
170311908005,1422,0,1422,99.2300033569,4.67000007629,95.3300018311
170311909001,1829,55,1884,94.9100036621,5.88999986649,94.1100006104
170311910001,1047,0,1047,99.4300003052,1.60000002384,98.4000015259
170311910002,1411,0,1411,94.8899993896,2.17000007629,97.8300018311
170311911001,866,0,866,100.0,5.57999992371,94.4199981689
170311911002,1037,0,1037,98.8600006104,12.1899995804,87.8099975586
170311911003,946,0,946,100.0,11.4300003052,88.5699996948
170311911004,1245,0,1245,85.2200012207,10.1199998856,89.8799972534
170311911005,1541,285,1826,87.1600036621,43.6899986267,56.3100013733
170311911006,891,41,932,95.7900009155,19.4400005341,80.5599975586
170311912001,2091,315,2406,93.2200012207,46.7400016785,53.2599983215
170311912002,1233,57,1290,96.9899978638,16.7600002289,83.2399978638
170311913011,2084,0,2084,97.9300003052,18.6599998474,81.3399963379
170311913012,1270,155,1425,93.1399993896,39.0299987793,60.9700012207
170311913013,1575,125,1700,97.3099975586,18.8099994659,81.1900024414
170311913021,2486,66,2552,98.4199981689,10.8199996948,89.1800003052
170311913022,2387,60,2447,100.0,7.23999977112,92.7600021362
170312001001,559,53,612,72.0,1.69000005722,98.3099975586
170312001002,1034,15,1049,74.1299972534,3.61999988556,96.3799972534
170312001003,1337,58,1395,66.6200027466,7.15000009537,92.8499984741
170312002001,833,0,833,72.6900024414,0.0,100.0
170312002002,1455,0,1455,82.5299987793,21.9599990845,78.0400009155
170312002003,814,260,1074,90.0999984741,22.1700000763,77.8300018311
170312002004,662,0,662,49.1800003052,0.0,100.0
170312003001,907,83,990,100.0,9.51000022888,90.4899978638
170312003002,1110,81,1191,98.1900024414,7.17999982834,92.8199996948
170312004011,895,0,895,74.3399963379,0.0,100.0
170312004012,1401,76,1477,61.0299987793,1.28999996185,98.7099990845
170312004021,1672,0,1672,100.0,8.93000030518,91.0699996948
170312004022,1212,0,1212,84.8099975586,5.92999982834,94.0699996948
170312004023,859,98,957,74.5899963379,0.0,100.0
170312101001,1279,85,1364,100.0,19.9300003052,80.0699996948
170312101002,1589,0,1589,100.0,8.32999992371,91.6699981689
170312101003,1042,0,1042,98.7699966431,6.98999977112,93.0100021362
170312104001,1754,12,1766,89.1500015259,4.19000005722,95.8099975586
170312104002,840,0,840,78.5,1.08000004292,98.9199981689
170312105011,1203,19,1222,99.5100021362,21.6200008392,78.3799972534
170312105012,2599,51,2650,97.7900009155,8.98999977112,91.0100021362
170312105021,1733,244,1977,97.4400024414,15.4399995804,84.5599975586
170312105022,1165,160,1325,100.0,0.0,100.0
170312105023,1116,0,1116,92.8499984741,10.6599998474,89.3399963379
170312106011,687,0,687,97.5899963379,18.4500007629,81.5500030518
170312106012,828,53,881,99.6600036621,16.9899997711,83.0100021362
170312106013,1379,131,1510,100.0,37.4700012207,62.5299987793
170312106021,1333,79,1412,93.0800018311,15.5200004578,84.4800033569
170312106022,1010,14,1024,100.0,24.8199996948,75.1800003052
170312106023,2166,41,2207,100.0,12.3199996948,87.6800003052
170312107001,995,11,1006,97.0999984741,21.8500003815,78.1500015259
170312107002,1446,11,1457,100.0,5.71000003815,94.2900009155
170312107003,1692,123,1815,100.0,19.7900009155,80.2099990845
170312108001,1149,33,1182,100.0,12.2399997711,87.7600021362
170312109001,1982,14,1996,95.3700027466,9.77999973297,90.2200012207
170312109002,1025,0,1025,98.9400024414,12.3500003815,87.6500015259
170312203001,1061,117,1178,100.0,47.2099990845,52.7900009155
170312203002,879,20,899,98.5699996948,34.3100013733,65.6900024414
170312204001,1075,10,1085,97.4800033569,34.0,66.0
170312204002,1342,41,1383,99.8600006104,37.5800018311,62.4199981689
170312205001,1068,0,1068,97.8000030518,38.25,61.75
170312205002,711,0,711,93.4300003052,24.5300006866,75.4700012207
170312205003,742,0,742,92.6299972534,22.9099998474,77.0899963379
170312206011,559,158,717,97.5500030518,22.0599994659,77.9400024414
170312206012,894,39,933,94.8199996948,3.95000004768,96.0500030518
170312206021,481,138,619,100.0,89.75,10.25
170312206022,235,23,258,62.6199989319,0.0,0.0
170312206023,648,0,648,50.9000015259,5.84999990463,94.1500015259
170312206024,987,17,1004,55.8400001526,0.0,100.0
170312206025,964,7,971,100.0,5.17999982834,94.8199996948
170312207011,760,65,825,84.7900009155,7.15000009537,92.8499984741
170312207012,660,74,734,81.7399978638,6.90999984741,93.0899963379
170312207013,1486,15,1501,94.6999969482,0.490000009537,99.5100021362
170312207021,828,103,931,69.2699966431,18.2900009155,81.7099990845
170312207022,839,0,839,91.1999969482,10.1800003052,89.8199996948
170312207023,612,36,648,78.0699996948,17.3799991608,82.6200027466
170312207024,713,0,713,69.0199966431,3.54999995232,96.4499969482
170312209011,372,418,790,75.8899993896,53.7099990845,46.2900009155
170312209012,772,0,772,62.7099990845,0.0,100.0
170312209013,1071,53,1124,88.2300033569,21.3999996185,78.5999984741
170312209021,1608,0,1608,97.9300003052,2.82999992371,97.1699981689
170312209022,1211,0,1211,66.9800033569,0.0,100.0
170312210001,986,0,986,67.6299972534,0.0,100.0
170312210002,1030,0,1030,71.9800033569,3.31999993324,96.6800003052
170312211001,1203,198,1401,86.1600036621,51.0699996948,48.9300003052
170312211002,1587,231,1818,81.2699966431,26.1599998474,73.8399963379
170312211003,979,0,979,81.4499969482,0.0,100.0
170312212001,1120,66,1186,100.0,57.7099990845,42.2900009155
170312212002,1420,131,1551,90.2300033569,66.1299972534,33.8699989319
170312213001,1247,20,1267,90.3700027466,4.96000003815,95.0400009155
170312213002,928,191,1119,98.9400024414,0.0,100.0
170312213003,380,148,528,81.3600006104,63.0200004578,36.9799995422
170312214001,951,0,951,92.9599990845,6.57000017166,93.4300003052
170312214002,807,0,807,100.0,0.0,100.0
170312214003,1220,25,1245,100.0,11.7299995422,88.2699966431
170312215001,1125,0,1125,99.2099990845,2.03999996185,97.9599990845
170312215002,1638,10,1648,100.0,10.3500003815,89.6500015259
170312216001,1282,33,1315,83.9199981689,23.7999992371,76.1999969482
170312216002,1427,0,1427,98.6200027466,5.76000022888,94.2399978638
170312222001,934,11,945,100.0,16.1100006104,83.8899993896
170312222002,939,0,939,94.9400024414,5.86000013351,94.1399993896
170312225001,1031,261,1292,90.9199981689,50.3899993896,49.6100006104
170312226001,1467,92,1559,100.0,49.7200012207,50.2799987793
170312227001,782,106,888,91.5500030518,29.1100006104,70.8899993896
170312227002,814,153,967,74.6699981689,15.9499998093,84.0500030518
170312228001,740,12,752,70.3499984741,2.28999996185,97.7099990845
170312229001,1068,0,1068,84.5599975586,10.0,90.0
170312301001,1377,229,1606,100.0,34.1500015259,65.8499984741
170312302001,1984,17,2001,94.4300003052,2.3599998951,97.6399993896
170312303001,748,20,768,75.8899993896,3.31999993324,96.6800003052
170312304001,1067,0,1067,78.9800033569,0.0,100.0
170312304002,1276,11,1287,100.0,2.54999995232,97.4499969482
170312305001,2071,68,2139,91.0599975586,2.54999995232,97.4499969482
170312305002,1014,0,1014,82.1699981689,3.38000011444,96.6200027466
170312306001,850,0,850,100.0,7.76000022888,92.2399978638
170312306002,1217,48,1265,100.0,6.26999998093,93.7300033569
170312306003,915,0,915,87.5599975586,2.59999990463,97.4000015259
170312306004,858,0,858,88.7300033569,14.6599998474,85.3399963379
170312306005,1272,193,1465,97.8600006104,13.970000267,86.0299987793
170312306006,923,53,976,71.0899963379,1.24000000954,98.7600021362
170312307001,1190,75,1265,81.6100006104,9.28999996185,90.7099990845
170312307002,1146,61,1207,97.8099975586,10.6899995804,89.3099975586
170312307003,1585,0,1585,100.0,20.0200004578,79.9800033569
170312307004,1944,4,1948,96.9599990845,7.61999988556,92.3799972534
170312308001,854,0,854,62.2000007629,0.0,100.0
170312309001,1660,62,1722,96.3099975586,12.9499998093,87.0500030518
170312309002,1967,0,1967,95.8600006104,2.16000008583,97.8399963379
170312309003,1088,0,1088,73.6100006104,0.0,100.0
170312311001,1118,58,1176,96.7900009155,5.84999990463,94.1500015259
170312312001,957,26,983,81.9800033569,2.38000011444,97.6200027466
170312312002,768,32,800,69.9300003052,8.69999980927,91.3000030518
170312312003,744,77,821,73.8300018311,32.5400009155,67.4599990845
170312312004,1044,15,1059,78.3300018311,20.4699993134,79.5299987793
170312312005,1247,29,1276,96.6699981689,12.4099998474,87.5899963379
170312315001,649,234,883,98.0,0.0,100.0
170312315002,319,625,944,100.0,73.5800018311,26.4200000763
170312315003,229,219,448,93.1399993896,82.6900024414,17.3099994659
170312315004,846,63,909,95.2799987793,1.90999996662,98.0899963379
170312315005,615,299,914,68.6699981689,17.1100006104,82.8899993896
170312315006,1159,69,1228,84.2799987793,12.5,87.5
170312402001,1119,276,1395,96.8099975586,28.7999992371,71.1999969482
170312403001,1227,0,1227,94.4599990845,2.83999991417,97.1600036621
170312405001,2229,0,2229,99.8199996948,6.90000009537,93.0999984741
170312406001,1297,0,1297,92.25,3.3599998951,96.6399993896
170312407001,1158,76,1234,77.1699981689,3.92000007629,96.0800018311
170312408001,461,151,612,94.7399978638,16.3400001526,83.6600036621
170312408002,749,150,899,93.1600036621,57.9500007629,42.0499992371
170312409001,659,302,961,75.1999969482,66.0899963379,33.9099998474
170312410001,647,0,647,63.4300003052,0.0,100.0
170312410002,542,27,569,55.4000015259,9.60999965668,90.3899993896
170312411001,1726,5,1731,100.0,10.8999996185,89.0999984741
170312411002,1740,0,1740,89.9199981689,0.0,100.0
170312412001,641,154,795,81.2900009155,13.6000003815,86.4000015259
170312412002,766,2,768,97.0899963379,27.8299999237,72.1699981689
170312413001,1476,176,1652,88.8600006104,9.22999954224,90.7699966431
170312414001,1229,43,1272,100.0,24.8600006104,75.1399993896
170312414002,965,0,965,98.4700012207,22.8299999237,77.1699981689
170312414003,975,0,975,100.0,2.16000008583,97.8399963379
170312414004,1362,17,1379,99.8600006104,19.6399993896,80.3600006104
170312415001,1328,0,1328,100.0,0.0,100.0
170312415002,682,0,682,96.4599990845,0.0,100.0
170312415003,826,0,826,94.9400024414,0.0,100.0
170312416001,1347,0,1347,97.5400009155,7.11999988556,92.8799972534
170312416002,2015,0,2015,97.8199996948,5.78000020981,94.2200012207
170312420001,1524,23,1547,99.1699981689,16.8700008392,83.1299972534
170312420002,1908,0,1908,98.0999984741,4.59000015259,95.4100036621
170312420003,933,78,1011,95.8300018311,24.9599990845,75.0400009155
170312421001,978,0,978,100.0,1.80999994278,98.1900024414
170312421002,963,0,963,90.9300003052,0.0,100.0
170312421003,1353,88,1441,95.6200027466,6.13999986649,93.8600006104
170312422001,1544,38,1582,91.5,21.75,78.25
170312422002,1618,144,1762,92.9800033569,20.3899993896,79.6100006104
170312423001,1418,0,1418,97.0599975586,13.9099998474,86.0899963379
170312423002,1632,0,1632,92.2600021362,7.13000011444,92.8700027466
170312424001,1093,0,1093,90.7099990845,30.5100002289,69.4899978638
170312424002,1469,0,1469,91.0199966431,4.71999979019,95.2799987793
170312425001,1471,170,1641,90.4599990845,31.4899997711,68.5100021362
170312425002,1381,0,1381,87.1800003052,7.80999994278,92.1900024414
170312426001,1422,55,1477,97.4899978638,4.38999986649,95.6100006104
170312426002,1572,104,1676,100.0,9.90999984741,90.0899963379
170312426003,1073,0,1073,66.2799987793,0.0,100.0
170312426004,602,42,644,60.5800018311,14.6599998474,85.3399963379
170312427001,1633,232,1865,92.1900024414,8.63000011444,91.3700027466
170312428001,1419,0,1419,98.1299972534,8.30000019073,91.6999969482
170312429001,1177,8,1185,96.8899993896,9.85999965668,90.1399993896
170312429002,460,0,460,100.0,6.69999980927,93.3000030518
170312430001,898,0,898,100.0,4.26999998093,95.7300033569
170312430002,1288,0,1288,95.4100036621,0.0,100.0
170312431001,1405,0,1405,94.3000030518,8.75,91.25
170312431002,805,0,805,100.0,4.88999986649,95.1100006104
170312432001,1131,0,1131,96.5,0.0,100.0
170312432002,977,0,977,98.6900024414,8.82999992371,91.1699981689
170312433001,781,0,781,97.9899978638,0.0,100.0
170312433002,1522,0,1522,96.2099990845,3.1400001049,96.8600006104
170312434001,1307,6,1313,97.9899978638,7.23999977112,92.7600021362
170312434002,479,0,479,81.5999984741,5.21999979019,94.7799987793
170312434003,955,0,955,95.2099990845,2.06999993324,97.9300003052
170312435001,709,33,742,65.1399993896,27.9799995422,72.0199966431
170312435002,1053,3,1056,58.2099990845,6.61000013351,93.3899993896
170312502001,1253,90,1343,91.2399978638,17.3700008392,82.6299972534
170312502002,1216,0,1216,100.0,1.23000001907,98.7699966431
170312503001,1128,114,1242,89.3499984741,20.8600006104,79.1399993896
170312503002,960,42,1002,97.0,14.7899999619,85.2099990845
170312503003,1059,344,1403,85.5,45.5400009155,54.4599990845
170312503004,278,210,488,71.7600021362,44.0400009155,55.9599990845
170312504001,442,200,642,98.7699966431,23.7800006866,76.2200012207
170312504002,1038,0,1038,92.3499984741,15.8999996185,84.0999984741
170312504003,1147,205,1352,100.0,22.0900001526,77.9100036621
170312504004,874,217,1091,96.4599990845,24.5400009155,75.4599990845
170312504005,1131,257,1388,83.8700027466,24.7099990845,75.2900009155
170312505001,292,655,947,75.9400024414,62.3400001526,37.6599998474
170312505002,1192,154,1346,92.6399993896,29.2800006866,70.7200012207
170312505003,761,57,818,89.5899963379,15.4600000381,84.5400009155
170312505004,354,310,664,61.5999984741,46.6300010681,53.3699989319
170312505005,137,347,484,62.9399986267,79.1299972534,20.8700008392
170312505006,608,101,709,85.6299972534,27.6499996185,72.3499984741
170312505007,961,263,1224,100.0,15.1099996567,84.8899993896
170312506001,927,0,927,90.6200027466,12.9600000381,87.0400009155
170312506002,1082,0,1082,97.2099990845,2.07999992371,97.9199981689
170312506003,1027,136,1163,95.4800033569,25.4699993134,74.5299987793
170312506004,854,138,992,92.8799972534,36.9500007629,63.0499992371
170312507001,987,220,1207,99.6699981689,25.8299999237,74.1699981689
170312507002,1108,5,1113,100.0,18.3299999237,81.6699981689
170312507003,1011,37,1048,100.0,11.25,88.75
170312507004,1094,0,1094,96.9000015259,9.84000015259,90.1600036621
170312507005,1260,0,1260,80.25,6.73999977112,93.2600021362
170312508001,1049,130,1179,91.8899993896,12.0600004196,87.9400024414
170312508002,1064,30,1094,91.7799987793,27.8299999237,72.1699981689
170312510001,1167,0,1167,100.0,6.65999984741,93.3399963379
170312511001,663,142,805,81.9800033569,26.1900005341,73.8099975586
170312511002,857,0,857,82.0899963379,4.59000015259,95.4100036621
170312511003,900,89,989,100.0,10.8800001144,89.1200027466
170312511004,1231,14,1245,97.5699996948,7.57000017166,92.4300003052
170312512001,712,6,718,99.0299987793,31.6000003815,68.4000015259
170312512002,835,55,890,94.9800033569,27.8700008392,72.1299972534
170312512003,715,43,758,84.0400009155,0.560000002384,99.4400024414
170312512004,1367,162,1529,90.6900024414,31.1499996185,68.8499984741
170312513001,1015,0,1015,100.0,8.36999988556,91.6299972534
170312513002,832,0,832,100.0,1.48000001907,98.5199966431
170312513003,583,92,675,79.6900024414,11.5100002289,88.4899978638
170312513004,573,139,712,73.25,16.2900009155,83.7099990845
170312513005,1096,186,1282,100.0,43.9099998474,56.0900001526
170312514001,662,27,689,85.8000030518,16.0400009155,83.9599990845
170312514002,516,148,664,87.25,26.2600002289,73.7399978638
170312514003,1124,93,1217,92.4100036621,18.5699996948,81.4300003052
170312514004,906,239,1145,98.3700027466,60.4099998474,39.5900001526
170312515001,939,7,946,97.7300033569,14.8800001144,85.1200027466
170312515002,557,155,712,74.8700027466,19.75,80.25
170312515003,955,51,1006,96.1800003052,6.32999992371,93.6699981689
170312515004,1408,228,1636,93.75,23.6499996185,76.3499984741
170312516001,1165,29,1194,85.1600036621,7.09000015259,92.9100036621
170312516002,410,90,500,46.0,0.0,0.0
170312516003,1033,134,1167,99.1500015259,17.6599998474,82.3399963379
170312517001,1190,210,1400,97.8300018311,15.4300003052,84.5699996948
170312518001,1123,62,1185,98.5,40.3199996948,59.6800003052
170312518002,814,145,959,94.1100006104,20.6100006104,79.3899993896
170312518003,913,5,918,95.1299972534,14.3100004196,85.6900024414
170312518004,687,5,692,99.1399993896,19.5900001526,80.4100036621
170312518005,811,235,1046,87.0899963379,40.9500007629,59.0499992371
170312519001,555,107,662,78.0699996948,22.3999996185,77.5999984741
170312519002,1414,116,1530,100.0,33.0600013733,66.9400024414
170312519003,1138,0,1138,94.6800003052,10.0399999619,89.9599990845
170312519004,2002,77,2079,99.0500030518,13.8100004196,86.1900024414
170312520001,496,164,660,93.2200012207,0.0,100.0
170312520002,2077,7,2084,99.0,6.32000017166,93.6800003052
170312520003,1004,675,1679,99.6399993896,60.8800010681,39.1199989319
170312520004,402,827,1229,100.0,75.8399963379,24.1599998474
170312521011,878,267,1145,79.1299972534,64.0800018311,35.9199981689
170312521021,1214,200,1414,80.6200027466,24.2800006866,75.7200012207
170312521022,1149,0,1149,79.6800003052,3.24000000954,96.7600021362
170312521023,1785,101,1886,99.2600021362,9.35999965668,90.6399993896
170312521024,986,0,986,78.0699996948,0.0,100.0
170312522011,290,402,692,86.2799987793,47.6699981689,52.3300018311
170312522012,239,106,345,41.6699981689,58.3100013733,41.6899986267
170312522013,583,428,1011,73.3099975586,67.2699966431,32.7299995422
170312522021,796,43,839,86.3199996948,11.029999733,88.9700012207
170312522022,777,63,840,89.4599990845,6.0,94.0
170312522023,822,53,875,90.3899993896,6.86000013351,93.1399993896
170312522024,495,53,548,90.8799972534,4.26000022888,95.7399978638
170312522025,991,63,1054,97.5899963379,2.71000003815,97.2900009155
170312601001,1248,0,1248,99.9199981689,6.40999984741,93.5899963379
170312602001,982,53,1035,94.7799987793,14.1199998856,85.8799972534
170312603001,1032,255,1287,81.9700012207,25.4500007629,74.5500030518
170312604001,721,168,889,67.8600006104,26.0699996948,73.9300003052
170312605001,469,342,811,41.7200012207,40.1399993896,59.8600006104
170312606001,320,76,396,36.1300010681,0.0,0.0
170312606002,781,102,883,64.3600006104,36.4599990845,63.5400009155
170312607001,514,94,608,80.1100006104,12.0900001526,87.9100036621
170312607002,1111,57,1168,90.5400009155,40.2200012207,59.7799987793
170312608001,1141,113,1254,98.9000015259,24.6100006104,75.3899993896
170312608002,1248,0,1248,99.1299972534,27.7800006866,72.2200012207
170312609001,843,70,913,100.0,14.1000003815,85.9000015259
170312609002,540,20,560,91.3499984741,5.21000003815,94.7900009155
170312610001,732,261,993,97.8300018311,20.25,79.75
170312610002,966,70,1036,79.1999969482,6.40999984741,93.5899963379
170312705001,1442,31,1473,84.6600036621,59.1599998474,40.8400001526
170312712001,1157,0,1157,98.2200012207,23.6900005341,76.3099975586
170312713001,939,0,939,88.6699981689,15.3299999237,84.6699981689
170312714001,592,384,976,65.0699996948,36.6599998474,63.3400001526
170312715001,851,141,992,71.3700027466,0.0,0.0
170312718001,712,96,808,83.3000030518,19.7700004578,80.2300033569
170312801001,2477,0,2477,65.4599990845,0.0,100.0
170312801002,883,0,883,80.1299972534,6.09999990463,93.9000015259
170312804001,1351,0,1351,99.7799987793,18.8700008392,81.1299972534
170312808001,692,15,707,88.4899978638,7.92999982834,92.0699996948
170312809001,900,0,900,96.1500015259,17.9400005341,82.0599975586
170312819001,0,0,0,0.0,10.1999998093,89.8000030518
170312819002,1472,0,1472,100.0,0.0,100.0
170312819003,1621,0,1621,76.8199996948,19.5499992371,80.4499969482
170312827001,1022,0,1022,95.9599990845,0.360000014305,99.6399993896
170312827002,1277,0,1277,95.0100021362,4.96000003815,95.0400009155
170312828001,1628,0,1628,96.2200012207,4.5,95.5
170312831001,568,586,1154,94.6699981689,66.3099975586,33.6899986267
170312831002,933,201,1134,76.5699996948,21.3500003815,78.6500015259
170312832001,1412,98,1510,88.8199996948,14.4600000381,85.5400009155
170312838001,622,0,622,89.6299972534,3.00999999046,96.9899978638
170312838002,1675,321,1996,68.6399993896,20.8700008392,79.1299972534
170312909001,948,77,1025,98.0899963379,15.8900003433,84.1100006104
170312909002,693,116,809,81.2200012207,12.6000003815,87.4000015259
170312909003,0,0,0,0.0,0.0,0.0
170312909004,988,0,988,73.1299972534,3.04999995232,96.9499969482
170312912001,1016,51,1067,92.1399993896,43.9700012207,56.0299987793
170312912002,861,90,951,87.25,46.9399986267,53.0600013733
170312916001,776,279,1055,100.0,38.0499992371,61.9500007629
170312922001,701,0,701,80.0199966431,0.0,100.0
170312922002,886,26,912,72.9599990845,3.90000009537,96.0999984741
170312922003,422,0,422,52.3600006104,0.0,100.0
170312924001,574,24,598,60.0400009155,0.0,0.0
170312924002,1231,32,1263,98.2900009155,3.67000007629,96.3300018311
170312925001,955,64,1019,77.9100036621,12.1700000763,87.8300018311
170312925002,1136,139,1275,98.3799972534,22.7000007629,77.3000030518
170312925003,613,347,960,96.4800033569,41.9599990845,58.0400009155
170312925004,0,0,0,0.0,4.88999986649,95.1100006104
170313005001,713,0,713,88.5699996948,9.26000022888,90.7399978638
170313005002,2244,0,2244,89.8000030518,2.68000006676,97.3199996948
170313006001,886,11,897,63.4799995422,7.90999984741,92.0899963379
170313006002,1344,0,1344,75.4199981689,0.0,100.0
170313007001,1430,183,1613,67.4599990845,11.9200000763,88.0800018311
170313007002,1334,0,1334,100.0,0.0,100.0
170313007003,675,0,675,44.5299987793,0.0,0.0
170313008001,2051,0,2051,96.0699996948,2.94000005722,97.0599975586
170313008002,2271,0,2271,94.4300003052,1.65999996662,98.3399963379
170313009001,1368,609,1977,99.9000015259,3.73000001907,96.2699966431
170313009002,2000,0,2000,98.2300033569,10.3400001526,89.6600036621
170313009003,1073,0,1073,97.5500030518,0.0,100.0
170313011001,1003,257,1260,100.0,81.0100021362,18.9899997711
170313011002,1353,0,1353,99.5599975586,25.0699996948,74.9300003052
170313012001,1347,0,1347,99.8499984741,10.25,89.75
170313012002,367,307,674,100.0,41.5200004578,58.4799995422
170313012003,1212,406,1618,81.1800003052,31.4500007629,68.5500030518
170313016001,1442,0,1442,66.2099990845,0.0,100.0
170313016002,0,0,0,0.0,0.0,0.0
170313017011,1330,46,1376,100.0,2.75999999046,97.2399978638
170313017012,626,42,668,48.4399986267,0.0,0.0
170313017013,1494,87,1581,98.1399993896,4.11000013351,95.8899993896
170313017021,285,0,285,24.3600006104,0.0,0.0
170313017022,1524,0,1524,97.0699996948,0.0,100.0
170313017023,0,0,0,0.0,0.0,0.0
170313018011,0,0,0,0.0,0.0,0.0
170313018012,1336,182,1518,52.8699989319,9.92000007629,90.0800018311
170313018021,804,0,804,100.0,1.72000002861,98.2799987793
170313018022,1337,31,1368,98.9199981689,0.25,99.75
170313018023,1329,0,1329,100.0,8.07999992371,91.9199981689
170313018031,1275,14,1289,73.4100036621,5.26000022888,94.7399978638
170313018032,1812,101,1913,75.7900009155,7.28999996185,92.7099990845
170313018033,0,0,0,0.0,0.0,0.0
170313102001,458,0,458,67.3499984741,16.0400009155,83.9599990845
170313102002,307,0,307,49.9199981689,4.57000017166,95.4300003052
170313103001,1643,1,1644,99.4599990845,9.31000041962,90.6900024414
170313104001,1332,0,1332,100.0,0.0,100.0
170313105001,1696,0,1696,99.3000030518,7.38000011444,92.6200027466
170313106001,2142,0,2142,97.8099975586,9.82999992371,90.1699981689
170313106002,1743,0,1743,95.7200012207,3.74000000954,96.2600021362
170313106003,1975,0,1975,100.0,0.0,100.0
170313107001,1641,0,1641,99.3899993896,9.75,90.25
170313108001,749,0,749,72.3000030518,0.0,100.0
170313108002,718,0,718,61.7900009155,0.0,100.0
170313108003,2202,0,2202,94.7900009155,2.72000002861,97.2799987793
170313109001,531,0,531,29.6599998474,0.0,0.0
170313109002,1541,16,1557,99.6200027466,3.1099998951,96.8899993896
170313109003,544,51,595,33.2599983215,0.0,0.0
170313201001,2422,576,2998,99.2699966431,50.9500007629,49.0499992371
170313201002,2295,0,2295,97.1200027466,1.69000005722,98.3099975586
170313201003,1346,0,1346,72.7200012207,0.0,100.0
170313201004,3886,245,4131,100.0,8.52999973297,91.4700012207
170313204001,758,0,758,30.1599998474,42.4500007629,57.5499992371
170313206001,1443,0,1443,80.2600021362,58.9099998474,41.0900001526
170313206002,1928,0,1928,84.8199996948,0.0,100.0
170313301001,2947,0,2947,87.0299987793,1.07000005245,98.9300003052
170313301002,4098,12,4110,94.1399993896,1.63999998569,98.3600006104
170313301003,5405,0,5405,97.2799987793,1.62000000477,98.3799972534
170313301004,3077,84,3161,100.0,20.9899997711,79.0100021362
170313302001,812,264,1076,99.8099975586,81.5299987793,18.4699993134
170313302002,1831,221,2052,69.6299972534,12.6099996567,87.3899993896
170313403001,1385,194,1579,88.8600006104,13.6899995804,86.3099975586
170313404001,1763,0,1763,96.0800018311,14.8100004196,85.1900024414
170313405001,1258,181,1439,94.7300033569,21.2700004578,78.7300033569
170313406001,720,150,870,95.3899993896,18.4300003052,81.5699996948
170313501001,205,627,832,99.8799972534,62.6699981689,37.3300018311
170313501002,370,854,1224,100.0,59.9300003052,40.0699996948
170313504001,371,4,375,97.6600036621,68.3499984741,31.6499996185
170313510001,548,40,588,100.0,48.4399986267,51.5600013733
170313510002,267,447,714,94.4400024414,49.5200004578,50.4799995422
170313510003,837,776,1613,88.9199981689,72.3000030518,27.7000007629
170313511001,1181,695,1876,100.0,24.0900001526,75.9100036621
170313511002,32,11,43,62.3199996948,0.0,0.0
170313511003,-99999,-99999,-99999,-99999.0,6.0,94.0
170313514001,1415,6,1421,100.0,28.1100006104,71.8899993896
170313515001,0,0,0,0.0,35.2400016785,64.7600021362
170313515002,255,0,255,100.0,16.9300003052,83.0699996948
170313602001,1217,199,1416,94.6500015259,39.5299987793,60.4700012207
170313801001,1614,176,1790,92.4100036621,27.9699993134,72.0299987793
170313802001,288,63,351,100.0,38.4599990845,61.5400009155
170313802002,1150,179,1329,100.0,0.0,100.0
170313805001,687,0,687,92.0899963379,39.6899986267,60.3100013733
170313807001,1234,0,1234,98.0100021362,37.2099990845,62.7900009155
170313812001,363,258,621,97.1800003052,72.6999969482,27.2999992371
170313812002,1381,0,1381,100.0,20.7999992371,79.1999969482
170313814001,1578,25,1603,96.2200012207,26.8500003815,73.1500015259
170313815001,236,0,236,96.7200012207,18.1800003052,81.8199996948
170313817001,-99999,-99999,-99999,-99999.0,43.2799987793,56.7200012207
170313818001,664,46,710,99.3000030518,43.0200004578,56.9799995422
170313818002,474,0,474,98.75,25.2800006866,74.7200012207
170313819001,443,65,508,87.4400024414,10.0399999619,89.9599990845
170313819002,568,117,685,92.9400024414,43.4099998474,56.5900001526
170313901001,703,507,1210,97.3499984741,46.9199981689,53.0800018311
170313902001,303,92,395,40.8100013733,0.0,100.0
170313902002,369,253,622,71.3300018311,11.8699998856,88.1299972534
170313903001,806,6,812,100.0,57.3899993896,42.6100006104
170313903002,1685,246,1931,95.4100036621,63.6899986267,36.3100013733
170313904001,955,300,1255,99.3700027466,47.7000007629,52.2999992371
170313904002,1084,588,1672,98.8799972534,79.4100036621,20.5900001526
170313905001,1064,515,1579,100.0,74.9300003052,25.0699996948
170313906001,454,346,800,96.7399978638,74.0599975586,25.9400005341
170313906002,588,435,1023,89.1900024414,84.9599990845,15.0399999619
170313907001,1426,22,1448,99.8600006104,55.3699989319,44.6300010681
170313907002,838,494,1332,96.3799972534,41.4399986267,58.5600013733
170313907003,2423,275,2698,100.0,52.1399993896,47.8600006104
170314003001,1531,1,1532,94.6299972534,64.0800018311,35.9199981689
170314004001,1268,28,1296,100.0,9.14999961853,90.8499984741
170314004002,634,25,659,100.0,12.4300003052,87.5699996948
170314005001,1101,0,1101,91.8300018311,19.4300003052,80.5699996948
170314005002,1082,0,1082,98.6299972534,21.8500003815,78.1500015259
170314008001,875,0,875,96.5800018311,6.88000011444,93.1200027466
170314008002,1758,0,1758,96.4899978638,10.3299999237,89.6699981689
170314101001,605,38,643,98.0199966431,46.8100013733,53.1899986267
170314101002,1150,4,1154,99.6500015259,59.4599990845,40.5400009155
170314102001,506,937,1443,100.0,82.1999969482,17.7999992371
170314105001,706,443,1149,92.1399993896,83.5500030518,16.4500007629
170314105002,1132,153,1285,100.0,41.7400016785,58.2599983215
170314106001,443,652,1095,82.7699966431,90.4800033569,9.52000045776
170314106002,513,459,972,95.8600006104,75.1500015259,24.8500003815
170314107001,1195,737,1932,89.7799987793,59.2900009155,40.7099990845
170314108001,570,331,901,90.6399993896,46.6300010681,53.3699989319
170314108002,806,77,883,54.2099990845,19.7299995422,80.2699966431
170314109001,549,187,736,100.0,58.8699989319,41.1300010681
170314109002,506,64,570,88.9199981689,56.3800010681,43.6199989319
170314109003,1232,300,1532,100.0,58.2799987793,41.7200012207
170314110001,1199,0,1199,100.0,28.2600002289,71.7399978638
170314110002,384,175,559,100.0,62.0099983215,37.9900016785
170314110003,1546,5,1551,97.3000030518,70.8899993896,29.1100006104
170314111001,531,318,849,86.1100006104,47.9300003052,52.0699996948
170314111002,246,561,807,74.0400009155,70.4300003052,29.5699996948
170314112001,521,483,1004,92.9599990845,71.7600021362,28.2399997711
170314112002,77,365,442,74.0400009155,67.1200027466,32.8800010681
170314201001,1337,64,1401,99.7900009155,62.9199981689,37.0800018311
170314202001,1541,126,1667,96.3000030518,9.52000045776,90.4800033569
170314203001,2071,338,2409,99.1399993896,19.5599994659,80.4400024414
170314204001,989,272,1261,93.1299972534,30.1800003052,69.8199996948
170314205001,767,410,1177,89.9800033569,46.1199989319,53.8800010681
170314205002,1203,116,1319,99.0199966431,31.7900009155,68.2099990845
170314206001,861,161,1022,98.9400024414,12.8900003433,87.1100006104
170314206002,1099,16,1115,95.3799972534,12.1700000763,87.8300018311
170314207001,548,0,548,99.0999984741,0.0,100.0
170314207002,505,0,505,100.0,10.4099998474,89.5899963379
170314207003,630,80,710,83.3300018311,31.5,68.5
170314207004,518,34,552,87.0699996948,7.30000019073,92.6999969482
170314207005,710,0,710,95.8199996948,1.5,98.5
170314208001,899,0,899,85.7799987793,0.0,100.0
170314208002,1087,22,1109,91.1299972534,12.0699996948,87.9300003052
170314212001,639,0,639,99.8399963379,12.2399997711,87.7600021362
170314212002,724,0,724,100.0,7.30000019073,92.6999969482
170314301011,570,0,570,73.1699981689,17.2399997711,82.7600021362
170314301012,800,0,800,100.0,15.0699996948,84.9300003052
170314301013,675,21,696,76.9899978638,27.1800003052,72.8199996948
170314301014,1251,31,1282,100.0,18.3600006104,81.6399993896
170314301021,1091,168,1259,98.5899963379,53.4199981689,46.5800018311
170314301022,740,0,740,100.0,7.75,92.25
170314301023,555,182,737,81.0800018311,0.0,0.0
170314302001,560,31,591,93.3600006104,33.7299995422,66.2699966431
170314302002,451,29,480,97.7600021362,16.5900001526,83.4100036621
170314302003,714,42,756,89.4700012207,14.8100004196,85.1900024414
170314302004,535,524,1059,90.8199996948,0.0,0.0
170314302005,1257,302,1559,97.0100021362,55.0600013733,44.9399986267
170314303001,1050,0,1050,96.6900024414,1.94000005722,98.0599975586
170314303002,456,86,542,92.1800003052,16.8799991608,83.1200027466
170314303003,372,87,459,70.1800003052,22.1599998474,77.8399963379
170314304001,528,23,551,99.6399993896,8.06999969482,91.9300003052
170314304002,409,108,517,65.6900024414,37.5600013733,62.4399986267
170314304003,628,0,628,73.8000030518,0.0,100.0
170314304004,672,0,672,98.8199996948,9.46000003815,90.5400009155
170314305001,1337,0,1337,99.6299972534,0.219999998808,99.7799987793
170314305002,976,118,1094,83.7699966431,23.2900009155,76.7099990845
170314305003,878,0,878,91.3600006104,4.61999988556,95.3799972534
170314306001,466,0,466,85.8199996948,1.08000004292,98.9199981689
170314306002,1014,8,1022,88.0999984741,4.96000003815,95.0400009155
170314307001,1036,120,1156,100.0,20.1900005341,79.8099975586
170314307002,983,0,983,87.8499984741,6.69999980927,93.3000030518
170314308001,717,7,724,90.2699966431,13.529999733,86.4700012207
170314308002,978,0,978,100.0,15.970000267,84.0299987793
170314309001,836,112,948,85.25,5.44000005722,94.5599975586
170314309002,661,40,701,96.0299987793,14.220000267,85.7799987793
170314312001,1396,71,1467,90.6100006104,23.2700004578,76.7300033569
170314312002,1316,81,1397,91.1900024414,21.3400001526,78.6600036621
170314313011,590,73,663,100.0,29.0300006866,70.9700012207
170314313012,1421,70,1491,91.9199981689,27.0599994659,72.9400024414
170314313013,1200,0,1200,100.0,11.3500003815,88.6500015259
170314313021,1238,0,1238,100.0,7.78999996185,92.2099990845
170314313022,1250,21,1271,99.2200012207,11.4099998474,88.5899963379
170314313023,1206,290,1496,92.5199966431,28.3400001526,71.6600036621
170314314001,2591,267,2858,100.0,27.6499996185,72.3499984741
170314314002,1419,38,1457,95.5999984741,27.2800006866,72.7200012207
170314314003,1587,186,1773,96.5699996948,40.3100013733,59.6899986267
170314314004,48,96,144,71.6399993896,79.0699996948,20.9300003052
170314401011,1031,15,1046,76.1299972534,5.34999990463,94.6500015259
170314401012,787,0,787,93.25,0.0,100.0
170314401013,240,0,240,66.8499984741,0.0,0.0
170314401014,1126,0,1126,95.0199966431,11.4399995804,88.5599975586
170314401021,812,1,813,90.6399993896,11.3599996567,88.6399993896
170314401022,634,0,634,99.8399963379,4.76000022888,95.2399978638
170314401023,773,0,773,95.9100036621,22.8700008392,77.1299972534
170314401024,774,0,774,100.0,26.0599994659,73.9400024414
170314402011,1280,0,1280,100.0,19.8099994659,80.1900024414
170314402012,1031,209,1240,81.5800018311,3.6400001049,96.3600006104
170314402013,724,0,724,100.0,0.0,100.0
170314402014,1057,467,1524,98.7699966431,45.9900016785,54.0099983215
170314402021,828,276,1104,97.6999969482,41.3899993896,58.6100006104
170314402022,830,332,1162,99.4899978638,29.1700000763,70.8300018311
170314402023,440,190,630,91.4400024414,49.9799995422,50.0200004578
170314403001,587,128,715,98.6200027466,35.6800003052,64.3199996948
170314403002,1086,285,1371,98.5599975586,35.0999984741,64.9000015259
170314403003,454,50,504,79.6200027466,22.4200000763,77.5800018311
170314403004,669,159,828,81.5,28.0,72.0
170314403005,952,2,954,95.3000030518,14.9899997711,85.0100021362
170314406001,517,196,713,83.7799987793,36.2299995422,63.7700004578
170314406002,831,170,1001,81.7799987793,23.1599998474,76.8399963379
170314407001,641,37,678,90.1600036621,19.8700008392,80.1299972534
170314407002,715,31,746,94.9100036621,22.2099990845,77.7900009155
170314408001,767,85,852,100.0,17.1499996185,82.8499984741
170314408002,758,142,900,99.3399963379,13.1800003052,86.8199996948
170314409001,750,0,750,74.8499984741,0.0,100.0
170314409002,620,3,623,85.6900024414,9.25,90.75
170314409003,387,163,550,62.0099983215,48.7599983215,51.2400016785
170314503001,1200,19,1219,92.2799987793,26.1100006104,73.8899993896
170314503002,629,26,655,94.2399978638,14.7399997711,85.2600021362
170314503003,871,61,932,95.7900009155,19.4099998474,80.5899963379
170314503004,573,0,573,87.8799972534,35.6899986267,64.3099975586
170314601001,1105,69,1174,95.5199966431,18.6900005341,81.3099975586
170314601002,454,241,695,100.0,68.8799972534,31.1200008392
170314601003,554,181,735,100.0,60.7999992371,39.2000007629
170314601004,751,0,751,100.0,18.3700008392,81.6299972534
170314602001,863,43,906,89.0899963379,11.0600004196,88.9400024414
170314602002,1266,74,1340,98.4599990845,25.4500007629,74.5500030518
170314603011,637,169,806,67.0500030518,0.0,100.0
170314603012,852,233,1085,99.7200012207,28.9300003052,71.0699996948
170314603013,642,130,772,71.2200012207,0.0,100.0
170314603021,691,0,691,100.0,2.0,98.0
170314603022,511,131,642,66.1200027466,0.0,0.0
170314603023,589,213,802,100.0,21.6299991608,78.3700027466
170314603024,864,155,1019,75.8700027466,17.9899997711,82.0100021362
170314604001,1113,92,1205,95.3300018311,34.0299987793,65.9700012207
170314604002,358,304,662,92.5899963379,59.7900009155,40.2099990845
170314604003,701,63,764,87.9199981689,38.4000015259,61.5999984741
170314604004,707,140,847,94.2200012207,39.3199996948,60.6800003052
170314605001,586,121,707,93.2699966431,30.0100002289,69.9899978638
170314605002,411,244,655,93.7099990845,56.7099990845,43.2900009155
170314605003,1107,1,1108,97.9700012207,18.5300006866,81.4700012207
170314605004,563,39,602,98.2099990845,15.5600004196,84.4400024414
170314605005,627,99,726,93.0800018311,28.2099990845,71.7900009155
170314605006,581,77,658,87.8499984741,42.2299995422,57.7700004578
170314605007,1045,23,1068,97.4499969482,19.4799995422,80.5199966431
170314606001,1129,42,1171,97.8300018311,17.8500003815,82.1500015259
170314607001,1017,187,1204,92.4700012207,36.4199981689,63.5800018311
170314607002,790,4,794,95.0899963379,5.90999984741,94.0899963379
170314607003,1152,0,1152,100.0,19.2900009155,80.7099990845
170314610001,1267,77,1344,92.5,6.98999977112,93.0100021362
170314701001,279,20,299,20.9699993134,10.1199998856,89.8799972534
170314701002,156,44,200,13.2600002289,45.1699981689,54.8300018311
170314801001,810,81,891,96.0100021362,26.0900001526,73.9100036621
170314801002,857,136,993,90.3499984741,37.0900001526,62.9099998474
170314802001,645,0,645,100.0,2.28999996185,97.7099990845
170314802002,394,15,409,67.4899978638,12.4799995422,87.5199966431
170314803001,626,0,626,72.1999969482,0.0,100.0
170314803002,548,0,548,98.3799972534,0.709999978542,99.2900009155
170314804001,177,5,182,21.3600006104,0.0,0.0
170314804002,3,0,3,0.389999985695,0.0,0.0
170314804003,536,373,909,78.2900009155,43.0099983215,56.9900016785
170314804004,505,149,654,81.6500015259,35.1300010681,64.8700027466
170314804005,506,4,510,82.1299972534,37.1899986267,62.8100013733
170314804006,596,103,699,85.6600036621,40.2299995422,59.7700004578
170314804007,608,116,724,82.4599990845,47.3800010681,52.6199989319
170314805001,516,338,854,76.25,66.7099990845,33.2900009155
170314805002,860,74,934,96.9899978638,22.1700000763,77.8300018311
170314805003,1059,41,1100,99.0999984741,25.8899993896,74.1100006104
170314903001,887,37,924,82.9400024414,14.4300003052,85.5699996948
170314903002,592,183,775,83.4199981689,27.6800003052,72.3199996948
170314904001,956,66,1022,96.9599990845,22.5200004578,77.4800033569
170314905001,919,81,1000,97.5599975586,36.2000007629,63.7999992371
170314905002,991,48,1039,85.3000030518,48.3100013733,51.6899986267
170314906001,1454,52,1506,96.6600036621,26.0400009155,73.9599990845
170314907001,755,185,940,99.4700012207,48.0900001526,51.9099998474
170314907002,741,10,751,100.0,15.029999733,84.9700012207
170314907003,1187,131,1318,94.3499984741,26.6800003052,73.3199996948
170314908001,713,47,760,100.0,40.6800003052,59.3199996948
170314908002,743,16,759,100.0,32.6100006104,67.3899993896
170314908003,1057,7,1064,100.0,20.9699993134,79.0299987793
170314908004,629,0,629,96.7699966431,13.3000001907,86.6999969482
170314908005,664,78,742,98.9300003052,17.4400005341,82.5599975586
170314909011,1408,158,1566,100.0,52.3300018311,47.6699981689
170314909012,856,329,1185,91.9300003052,24.5300006866,75.4700012207
170314909013,861,93,954,90.8600006104,73.5699996948,26.4300003052
170314909021,741,88,829,100.0,48.7099990845,51.2900009155
170314909022,1499,378,1877,89.9800033569,29.8600006104,70.1399993896
170314909023,806,407,1213,91.8899993896,46.7299995422,53.2700004578
170314909024,718,114,832,100.0,38.1399993896,61.8600006104
170314910001,509,14,523,87.0199966431,20.0900001526,79.9100036621
170314910002,931,218,1149,94.1800003052,29.8600006104,70.1399993896
170314910003,92,57,149,31.2399997711,25.4400005341,74.5599975586
170314910004,1205,133,1338,95.9100036621,33.4900016785,66.5100021362
170314910005,972,238,1210,74.1399993896,19.4300003052,80.5699996948
170314911001,430,71,501,74.0,24.0400009155,75.9599990845
170314911002,301,334,635,81.4100036621,66.5500030518,33.4500007629
170314911003,461,96,557,64.4700012207,3.90000009537,96.0999984741
170314911004,1053,88,1141,91.5,22.4500007629,77.5500030518
170314911005,834,71,905,95.5599975586,13.5200004578,86.4800033569
170314912001,642,90,732,67.8399963379,17.2700004578,82.7300033569
170314912002,564,82,646,87.0599975586,12.0,88.0
170314912003,557,28,585,90.9800033569,11.8699998856,88.1299972534
170314913001,736,109,845,94.4100036621,20.7700004578,79.2300033569
170314913002,537,69,606,91.4000015259,33.7799987793,66.2200012207
170314913003,402,87,489,70.5599975586,14.2899999619,85.7099990845
170314913004,251,200,451,69.4899978638,51.8199996948,48.1800003052
170314914001,903,0,903,100.0,44.6699981689,55.3300018311
170314914002,521,142,663,80.9499969482,23.6800003052,76.3199996948
170314914003,1086,55,1141,92.0199966431,34.5400009155,65.4599990845
170315001001,597,12,609,84.2300033569,9.60000038147,90.4000015259
170315001002,201,64,265,37.9099998474,0.0,100.0
170315001003,441,159,600,70.5899963379,13.0399999619,86.9599990845
170315001004,1204,131,1335,97.7300033569,25.4799995422,74.5199966431
170315002001,683,243,926,66.9100036621,22.4500007629,77.5500030518
170315002002,365,217,582,95.25,26.8500003815,73.1500015259
170315003001,273,139,412,67.3199996948,18.4099998474,81.5899963379
170315003002,887,122,1009,96.2799987793,42.2799987793,57.7200012207
170315101001,1055,124,1179,79.6600036621,8.27999973297,91.7200012207
170315101002,108,0,108,5.36999988556,8.36999988556,91.6299972534
170315102001,878,108,986,100.0,28.7199993134,71.2799987793
170315102002,541,79,620,72.3499984741,0.0,0.0
170315102003,783,165,948,85.8700027466,16.9200000763,83.0800018311
170315103001,435,57,492,36.4700012207,43.2799987793,56.7200012207
170315103002,697,23,720,62.8300018311,24.3199996948,75.6800003052
170315103003,466,47,513,69.2300033569,18.3700008392,81.6299972534
170315103004,301,12,313,14.2700004578,6.96999979019,93.0299987793
170315201001,1886,138,2024,100.0,9.30000019073,90.6999969482
170315202001,789,16,805,96.2900009155,3.24000000954,96.7600021362
170315202002,1220,14,1234,86.1699981689,23.2399997711,76.7600021362
170315202003,1595,0,1595,96.5500030518,6.23999977112,93.7600021362
170315203001,1183,158,1341,73.8000030518,14.5500001907,85.4499969482
170315203002,1490,0,1490,100.0,15.7100000381,84.2900009155
170315203003,1106,140,1246,100.0,39.7299995422,60.2700004578
170315203004,799,564,1363,79.4300003052,63.1699981689,36.8300018311
170315204001,766,33,799,100.0,13.3599996567,86.6399993896
170315204002,966,25,991,97.4400024414,23.8299999237,76.1699981689
170315204003,987,37,1024,100.0,12.220000267,87.7799987793
170315204004,1218,4,1222,98.3099975586,5.86000013351,94.1399993896
170315205001,382,34,416,48.0400009155,21.0,79.0
170315205002,913,131,1044,49.8600006104,19.9500007629,80.0500030518
170315205003,0,0,0,0.0,0.0,0.0
170315206001,1452,567,2019,78.0400009155,32.2200012207,67.7799987793
170315301001,898,5,903,68.7699966431,11.5399999619,88.4599990845
170315301002,354,249,603,58.6599998474,52.5099983215,47.4900016785
170315302001,683,138,821,90.7200012207,27.8999996185,72.0999984741
170315302002,556,106,662,96.9300003052,29.1100006104,70.8899993896
170315302003,577,54,631,99.3700027466,18.3899993896,81.6100006104
170315302004,1186,230,1416,93.5299987793,26.6299991608,73.3700027466
170315302005,490,164,654,45.7999992371,0.0,0.0
170315303001,726,81,807,90.3700027466,13.5600004196,86.4400024414
170315303002,595,23,618,75.8300018311,16.1499996185,83.8499984741
170315303003,483,119,602,64.0400009155,23.6399993896,76.3600006104
170315303004,925,513,1438,90.6100006104,48.8800010681,51.1199989319
170315304001,341,22,363,36.2999992371,10.4499998093,89.5500030518
170315304002,570,70,640,52.3699989319,18.8500003815,81.1500015259
170315305011,890,117,1007,74.3199996948,7.73000001907,92.2699966431
170315305012,578,105,683,44.3800010681,13.6999998093,86.3000030518
170315305013,0,0,0,0.0,0.0,0.0
170315305014,806,466,1272,84.5199966431,43.9900016785,56.0099983215
170315305021,811,159,970,57.9500007629,38.4199981689,61.5800018311
170315305031,1046,187,1233,83.9899978638,43.7400016785,56.2599983215
170315305032,718,348,1066,48.9700012207,39.4900016785,60.5099983215
170315305033,966,242,1208,71.3099975586,24.9500007629,75.0500030518
170315306001,418,48,466,35.25,30.7999992371,69.1999969482
170315306002,292,481,773,82.0599975586,79.6399993896,20.3600006104
170315306003,428,258,686,79.1200027466,41.5600013733,58.4399986267
170315401011,442,126,568,46.0999984741,40.9700012207,59.0299987793
170315401012,419,220,639,73.0299987793,45.8300018311,54.1699981689
170315401013,227,40,267,21.8299999237,0.0,0.0
170315401014,0,0,0,0.0,13.029999733,86.9700012207
170315401021,539,206,745,87.9599990845,12.3400001526,87.6600036621
170315401022,1375,109,1484,98.6699981689,14.4799995422,85.5199966431
170315401023,131,22,153,19.2000007629,0.0,0.0
170315501001,728,75,803,76.4000015259,30.3600006104,69.6399993896
170315501002,251,117,368,45.8899993896,19.7900009155,80.2099990845
170315501003,1035,314,1349,93.8799972534,25.4200000763,74.5800018311
170315501004,399,79,478,59.0900001526,14.3699998856,85.6299972534
170315501005,199,71,270,35.4799995422,11.1199998856,88.8799972534
170315501006,174,26,200,11.779999733,0.0,0.0
170315502001,964,28,992,52.7900009155,3.1400001049,96.8600006104
170315502002,689,144,833,84.6500015259,18.6900005341,81.3099975586
170315601001,1274,54,1328,98.1500015259,23.3199996948,76.6800003052
170315602001,73,103,176,59.2599983215,81.0500030518,18.9500007629
170315602002,0,0,0,0.0,36.6100006104,63.3899993896
170315602003,460,2,462,33.0,0.0,100.0
170315603001,680,0,680,39.9099998474,2.73000001907,97.2699966431
170315603002,680,15,695,47.7299995422,0.0,100.0
170315604001,1457,0,1457,96.1100006104,4.73999977112,95.2600021362
170315607001,1220,90,1310,98.4199981689,15.1899995804,84.8099975586
170315607002,1864,14,1878,87.8399963379,3.3900001049,96.6100006104
170315608001,1016,19,1035,87.7900009155,5.98000001907,94.0199966431
170315608002,980,0,980,65.8600006104,1.86000001431,98.1399993896
170315608003,425,0,425,49.7700004578,7.28999996185,92.7099990845
170315608004,366,13,379,49.4099998474,10.2399997711,89.7600021362
170315608005,427,0,427,38.5400009155,6.78000020981,93.2200012207
170315609001,339,15,354,32.2999992371,7.21999979019,92.7799987793
170315609002,196,0,196,31.8199996948,0.0,100.0
170315609003,349,0,349,39.1300010681,0.0,100.0
170315609004,572,19,591,58.1100006104,2.6400001049,97.3600006104
170315609005,263,227,490,74.8099975586,84.6299972534,15.3699998856
170315609006,678,20,698,83.8899993896,5.38000011444,94.6200027466
170315610001,931,63,994,100.0,17.2600002289,82.7399978638
170315610002,201,9,210,33.9799995422,5.30000019073,94.6999969482
170315610003,298,9,307,30.6700000763,3.70000004768,96.3000030518
170315610004,208,24,232,34.4700012207,9.85000038147,90.1500015259
170315610005,374,0,374,37.4700012207,1.72000002861,98.2799987793
170315610006,832,15,847,96.25,2.00999999046,97.9899978638
170315611001,668,54,722,100.0,22.5400009155,77.4599990845
170315611002,0,11,11,1.37999999523,0.0,0.0
170315611003,500,69,569,76.3799972534,20.4500007629,79.5500030518
170315611004,434,9,443,37.7700004578,8.56000041962,91.4400024414
170315611005,491,22,513,39.3100013733,21.0799999237,78.9199981689
170315611006,533,122,655,94.9300003052,37.2000007629,62.7999992371
170315701001,1180,12,1192,90.5100021362,16.2800006866,83.7200012207
170315702001,1609,30,1639,84.0100021362,14.0600004196,85.9400024414
170315703001,1277,0,1277,93.0800018311,0.0,100.0
170315703002,1000,0,1000,100.0,2.5,97.5
170315703003,1123,9,1132,74.7699966431,4.75,95.25
170315703004,1630,70,1700,76.3700027466,10.8199996948,89.1800003052
170315704001,920,0,920,100.0,12.7899999619,87.2099990845
170315704002,647,15,662,96.3600006104,18.5499992371,81.4499969482
170315705001,836,88,924,95.5500030518,7.48999977112,92.5100021362
170315705002,876,85,961,64.2799987793,23.2199993134,76.7799987793
170315801001,1342,14,1356,95.4300003052,7.65000009537,92.3499984741
170315801002,1469,75,1544,97.5400009155,16.0499992371,83.9499969482
170315802001,1336,35,1371,95.3399963379,29.5499992371,70.4499969482
170315802002,1821,259,2080,100.0,32.4199981689,67.5800018311
170315803001,1104,398,1502,61.6100006104,24.4799995422,75.5199966431
170315804001,792,0,792,61.6300010681,3.51999998093,96.4800033569
170315804002,1149,0,1149,98.5400009155,10.1700000763,89.8300018311
170315804003,1266,0,1266,100.0,7.23999977112,92.7600021362
170315804004,1009,0,1009,91.0599975586,1.19000005722,98.8099975586
170315805011,1259,32,1291,97.6600036621,14.3699998856,85.6299972534
170315805012,721,33,754,96.7900009155,2.84999990463,97.1500015259
170315805013,1546,79,1625,99.4499969482,5.15000009537,94.8499984741
170315805014,1283,75,1358,99.1999969482,27.9899997711,72.0100021362
170315805021,1092,65,1157,94.7600021362,12.6400003433,87.3600006104
170315805022,261,0,261,17.2099990845,0.0,0.0
170315805023,1902,50,1952,73.8300018311,6.28999996185,93.7099990845
170315806001,407,0,407,42.75,2.75,97.25
170315806002,891,0,891,65.9000015259,0.0,100.0
170315806003,90,0,90,5.63999986649,0.0,0.0
170315806004,0,0,0,0.0,0.0,0.0
170315807001,867,25,892,73.9000015259,62.3899993896,37.6100006104
170315807002,2612,50,2662,89.7200012207,52.5800018311,47.4199981689
170315807003,1182,64,1246,66.1699981689,0.0,0.0
170315808001,1516,370,1886,94.4899978638,54.5499992371,45.4500007629
170315905001,1633,24,1657,92.9300003052,38.9799995422,61.0200004578
170315906001,1018,176,1194,100.0,41.3300018311,58.6699981689
170315906002,733,277,1010,81.0599975586,0.0,0.0
170315906003,1003,64,1067,98.25,23.7399997711,76.2600021362
170315907001,1351,0,1351,83.0400009155,1.23000001907,98.7699966431
170315907002,1443,0,1443,100.0,6.63999986649,93.3600006104
170316004001,924,100,1024,72.4700012207,0.0,0.0
170316004002,925,0,925,100.0,7.13999986649,92.8600006104
170316004003,1488,0,1488,95.0199966431,0.0,100.0
170316006001,1773,0,1773,96.5699996948,3.74000000954,96.2600021362
170316006002,908,0,908,99.0199966431,24.4300003052,75.5699996948
170316007001,1191,7,1198,99.8300018311,7.65000009537,92.3499984741
170316007002,1289,0,1289,93.4100036621,1.45000004768,98.5500030518
170316009001,679,0,679,97.9800033569,0.0,100.0
170316009002,1102,0,1102,100.0,10.6199998856,89.3799972534
170316009003,709,0,709,99.0199966431,0.259999990463,99.7399978638
170316009004,1028,147,1175,97.9199981689,14.3299999237,85.6699981689
170316103001,1007,0,1007,49.4099998474,6.53999996185,93.4599990845
170316103002,416,13,429,21.4799995422,0.0,100.0
170316103003,1559,62,1621,98.0599975586,14.1700000763,85.8300018311
170316104001,2056,0,2056,94.1800003052,1.25,98.75
170316108001,975,18,993,72.5899963379,10.7399997711,89.2600021362
170316110001,834,100,934,86.7200012207,26.3899993896,73.6100006104
170316111001,915,99,1014,100.0,27.7700004578,72.2300033569
170316111002,576,0,576,100.0,19.2399997711,80.7600021362
170316111003,1052,160,1212,92.4499969482,21.8500003815,78.1500015259
170316112001,859,62,921,79.3300018311,16.4799995422,83.5199966431
170316112002,1559,92,1651,96.8300018311,14.0799999237,85.9199981689
170316113001,837,12,849,98.9499969482,2.20000004768,97.8000030518
170316113002,1041,0,1041,92.7799987793,0.0,100.0
170316113003,1282,32,1314,86.1600036621,0.0,100.0
170316114001,1301,144,1445,83.8700027466,0.0,100.0
170316114002,790,121,911,94.3099975586,40.2299995422,59.7700004578
170316114003,1418,5,1423,97.3300018311,20.8299999237,79.1699981689
170316115001,1222,81,1303,100.0,18.7700004578,81.2300033569
170316115002,2088,76,2164,93.0400009155,27.3099994659,72.6900024414
170316116001,624,143,767,100.0,40.7400016785,59.2599983215
170316116002,585,207,792,93.7300033569,45.1699981689,54.8300018311
170316117001,497,88,585,88.0999984741,15.8400001526,84.1600036621
170316117002,436,146,582,92.0899963379,45.3600006104,54.6399993896
170316117003,536,145,681,98.1299972534,28.9300003052,71.0699996948
170316118001,1359,68,1427,97.1399993896,9.42000007629,90.5800018311
170316118002,575,25,600,95.0899963379,10.9099998474,89.0899963379
170316119001,1370,0,1370,97.7900009155,13.1899995804,86.8099975586
170316119002,548,16,564,84.9400024414,62.7799987793,37.2200012207
170316120001,471,61,532,99.4400024414,33.2999992371,66.6999969482
170316120002,754,165,919,90.4499969482,39.3899993896,60.6100006104
170316121001,1338,75,1413,98.1900024414,23.2099990845,76.7900009155
170316201001,357,19,376,30.25,0.0,100.0
170316201002,944,79,1023,53.7000007629,0.0,100.0
170316201003,922,176,1098,93.7699966431,25.7000007629,74.3000030518
170316202001,803,2,805,83.8499984741,5.98000001907,94.0199966431
170316202002,736,189,925,72.4400024414,29.5400009155,70.4599990845
170316203001,926,16,942,94.7699966431,21.5300006866,78.4700012207
170316203002,805,0,805,76.5199966431,0.0,100.0
170316203003,362,67,429,39.1399993896,15.0500001907,84.9499969482
170316203004,592,96,688,70.7099990845,14.470000267,85.5299987793
170316203005,9,0,9,1.07000005245,0.0,0.0
170316203006,785,0,785,57.6800003052,0.0,100.0
170316204001,961,88,1049,78.6399993896,12.8800001144,87.1200027466
170316204002,0,0,0,0.0,0.0,0.0
170316204003,737,79,816,73.5100021362,10.6400003433,89.3600006104
170316204004,1158,33,1191,88.6200027466,11.8299999237,88.1699981689
170316301001,969,161,1130,95.5999984741,53.2900009155,46.7099990845
170316302001,1833,37,1870,96.8899993896,12.1199998856,87.8799972534
170316303001,933,119,1052,42.3199996948,16.7700004578,83.2300033569
170316303002,2510,239,2749,89.4599990845,8.61999988556,91.3799972534
170316304001,1122,154,1276,73.3799972534,13.5500001907,86.4499969482
170316304002,967,144,1111,70.4899978638,20.1700000763,79.8300018311
170316304003,1762,0,1762,90.7300033569,14.0399999619,85.9599990845
170316304004,1724,0,1724,91.1699981689,0.0,100.0
170316305001,1743,0,1743,95.7699966431,14.1199998856,85.8799972534
170316305002,1023,199,1222,91.5400009155,29.0900001526,70.9100036621
170316305003,955,207,1162,69.8700027466,21.3999996185,78.5999984741
170316305004,1053,72,1125,75.25,5.42999982834,94.5699996948
170316308001,1599,110,1709,97.6600036621,13.0,87.0
170316308002,1244,68,1312,66.9700012207,0.0,100.0
170316308003,624,0,624,37.3699989319,0.0,100.0
170316308004,614,0,614,34.7299995422,0.0,100.0
170316309001,1805,0,1805,100.0,4.30000019073,95.6999969482
170316309002,470,0,470,26.0400009155,0.0,0.0
170316309003,616,137,753,41.6699981689,25.3600006104,74.6399993896
170316401001,1141,27,1168,96.6100006104,13.1400003433,86.8600006104
170316403001,854,12,866,100.0,2.80999994278,97.1900024414
170316403002,948,0,948,79.4000015259,3.45000004768,96.5500030518
170316403003,763,43,806,99.3799972534,8.48999977112,91.5100021362
170316403004,237,14,251,16.9099998474,5.34999990463,94.6500015259
170316403005,640,0,640,72.1500015259,4.92000007629,95.0800018311
170316403006,469,4,473,38.5800018311,7.48999977112,92.5100021362
170316404001,1000,196,1196,84.4599990845,24.7000007629,75.3000030518
170316404002,801,46,847,47.0299987793,7.80999994278,92.1900024414
170316405001,1437,0,1437,78.3499984741,2.22000002861,97.7799987793
170316405002,1186,29,1215,73.5500030518,10.9499998093,89.0500030518
170316406001,710,0,710,73.9599990845,0.0,100.0
170316406002,1197,28,1225,83.3300018311,4.26999998093,95.7300033569
170316406003,970,0,970,65.5800018311,0.0,100.0
170316407001,687,21,708,94.6500015259,8.15999984741,91.8399963379
170316407002,550,55,605,77.9599990845,9.27999973297,90.7200012207
170316407003,523,24,547,67.6100006104,5.28000020981,94.7200012207
170316407004,646,0,646,81.7699966431,0.0,100.0
170316408001,868,0,868,97.0899963379,1.41999995708,98.5800018311
170316408002,761,21,782,92.9800033569,12.1400003433,87.8600006104
170316501001,0,0,0,0.0,0.0,0.0
170316501002,709,209,918,70.2399978638,21.3400001526,78.6600036621
170316501003,851,68,919,90.8099975586,8.86999988556,91.1299972534
170316501004,756,50,806,69.1800003052,9.44999980927,90.5500030518
170316502001,708,0,708,57.8400001526,0.0,100.0
170316502002,1388,0,1388,91.0800018311,14.4899997711,85.5100021362
170316502003,841,149,990,66.9800033569,19.1299991608,80.8700027466
170316502004,0,0,0,0.0,0.0,0.0
170316502005,0,0,0,0.0,0.0,0.0
170316502006,538,35,573,70.6500015259,5.71999979019,94.2799987793
170316503011,970,66,1036,80.6200027466,30.5599994659,69.4400024414
170316503012,1136,179,1315,72.3300018311,7.36999988556,92.6299972534
170316503013,1239,33,1272,89.0100021362,4.94000005722,95.0599975586
170316503014,942,82,1024,88.1200027466,24.9799995422,75.0199966431
170316503021,1791,165,1956,99.5899963379,6.63000011444,93.3700027466
170316503022,1233,392,1625,68.3099975586,30.3199996948,69.6800003052
170316504001,598,201,799,78.6399993896,30.8799991608,69.1200027466
170316504002,833,29,862,76.9599990845,7.84000015259,92.1600036621
170316504003,1041,226,1267,77.0199966431,29.1800003052,70.8199996948
170316504004,1340,33,1373,95.1500015259,5.82999992371,94.1699981689
170316504005,1280,0,1280,88.3399963379,5.01000022888,94.9899978638
170316505001,1139,21,1160,94.7699966431,1.84000003338,98.1600036621
170316505002,1032,69,1101,73.0599975586,14.8100004196,85.1900024414
170316505003,899,56,955,54.3499984741,7.63999986649,92.3600006104
170316603011,1726,31,1757,97.0199966431,1.73000001907,98.2699966431
170316603021,0,0,0,0.0,0.0,0.0
170316603022,1448,0,1448,96.9899978638,0.0,100.0
170316603023,480,0,480,34.7099990845,0.0,0.0
170316603024,849,9,858,59.7900009155,0.0,0.0
170316604001,991,98,1089,73.4300003052,9.03999996185,90.9599990845
170316604002,1294,33,1327,93.0599975586,2.52999997139,97.4700012207
170316604003,882,65,947,69.8899993896,7.09000015259,92.9100036621
170316604004,0,0,0,0.0,0.0,0.0
170316605001,1190,0,1190,91.8899993896,3.5,96.5
170316605002,1217,206,1423,91.5100021362,21.6900005341,78.3099975586
170316605003,646,396,1042,82.6999969482,45.7900009155,54.2099990845
170316605004,1111,0,1111,74.7600021362,0.920000016689,99.0800018311
170316606001,845,0,845,100.0,0.0,100.0
170316606002,799,81,880,72.5500030518,13.3400001526,86.6600036621
170316606003,775,94,869,73.6399993896,12.6700000763,87.3300018311
170316606004,1021,0,1021,73.0299987793,4.28000020981,95.7200012207
170316606005,1581,0,1581,94.5599975586,1.91999995708,98.0800018311
170316607001,1110,0,1110,96.0199966431,1.75,98.25
170316607002,1153,46,1199,99.25,12.3299999237,87.6699981689
170316608001,828,0,828,100.0,14.4799995422,85.5199966431
170316608002,453,282,735,70.3300018311,51.7200012207,48.2799987793
170316608003,673,214,887,73.3099975586,28.0100002289,71.9899978638
170316608004,529,330,859,76.6999969482,44.0099983215,55.9900016785
170316608005,1556,45,1601,95.2399978638,14.1999998093,85.8000030518
170316609001,1114,168,1282,95.4599990845,26.4099998474,73.5899963379
170316609002,1180,0,1180,98.0100021362,4.07999992371,95.9199981689
170316609003,1017,130,1147,67.9499969482,55.2200012207,44.7799987793
170316610001,1017,0,1017,98.8300018311,10.5200004578,89.4800033569
170316610002,848,0,848,97.6999969482,0.589999973774,99.4100036621
170316610003,959,0,959,100.0,3.61999988556,96.3799972534
170316610004,947,0,947,72.0699996948,7.07999992371,92.9199981689
170316610005,876,103,979,63.7799987793,13.6099996567,86.3899993896
170316611001,966,75,1041,76.7699966431,12.3000001907,87.6999969482
170316611002,321,0,321,35.3899993896,0.0,100.0
170316611003,1066,0,1066,89.6600036621,11.7299995422,88.2699966431
170316611004,1067,141,1208,93.3499984741,23.3299999237,76.6699981689
170316611005,716,212,928,50.9599990845,24.3799991608,75.6200027466
170316701001,593,158,751,100.0,47.6300010681,52.3699989319
170316701002,425,197,622,80.8799972534,77.3099975586,22.6900005341
170316702001,1083,49,1132,80.5100021362,42.1800003052,57.8199996948
170316703001,450,12,462,92.2200012207,7.09000015259,92.9100036621
170316703002,744,0,744,84.2600021362,56.0499992371,43.9500007629
170316704001,1670,106,1776,90.1999969482,43.2599983215,56.7400016785
170316705001,1184,125,1309,95.2699966431,44.0400009155,55.9599990845
170316706001,583,188,771,77.1800003052,23.8099994659,76.1900024414
170316706002,516,65,581,88.9700012207,29.7000007629,70.3000030518
170316707001,536,21,557,75.3700027466,8.17000007629,91.8300018311
170316707002,688,0,688,95.0299987793,2.24000000954,97.7600021362
170316708001,480,0,480,66.2099990845,0.0,0.0
170316708002,908,0,908,97.3199996948,3.06999993324,96.9300003052
170316709001,555,21,576,99.4800033569,7.71999979019,92.2799987793
170316709002,512,5,517,67.8499984741,5.38000011444,94.6200027466
170316711001,958,91,1049,81.9499969482,7.55000019073,92.4499969482
170316712001,551,0,551,100.0,5.36999988556,94.6299972534
170316712002,571,34,605,84.1399993896,0.0,100.0
170316713001,1305,0,1305,97.75,6.65999984741,93.3399963379
170316713002,505,126,631,92.3899993896,38.2599983215,61.7400016785
170316713003,638,13,651,98.9400024414,13.3800001144,86.6200027466
170316714001,944,140,1084,94.2600021362,26.7800006866,73.2200012207
170316714002,900,87,987,100.0,34.4900016785,65.5100021362
170316715001,644,88,732,100.0,21.5900001526,78.4100036621
170316715002,1321,84,1405,99.2900009155,33.1100006104,66.8899993896
170316715003,857,134,991,92.5299987793,15.9499998093,84.0500030518
170316716001,930,46,976,99.5899963379,22.8600006104,77.1399993896
170316716002,771,35,806,92.6399993896,13.5399999619,86.4599990845
170316716003,601,0,601,94.5,17.0400009155,82.9599990845
170316718001,1247,175,1422,100.0,28.4899997711,71.5100021362
170316719001,1219,159,1378,98.0800018311,10.5699996948,89.4300003052
170316720001,931,18,949,100.0,14.3599996567,85.6399993896
170316720002,958,16,974,100.0,7.65000009537,92.3499984741
170316720003,1054,57,1111,99.9100036621,23.5599994659,76.4400024414
170316720004,577,53,630,89.6200027466,18.2800006866,81.7200012207
170316805001,396,135,531,96.1999969482,58.4900016785,41.5099983215
170316805002,545,181,726,76.4199981689,58.9000015259,41.0999984741
170316806001,204,36,240,49.9000015259,0.0,0.0
170316806002,791,161,952,99.1699981689,20.0799999237,79.9199981689
170316809001,1103,36,1139,81.0100021362,15.470000267,84.5299987793
170316809002,619,74,693,91.3000030518,18.9200000763,81.0800018311
170316809003,899,33,932,100.0,16.75,83.25
170316809004,353,185,538,58.1599998474,5.96000003815,94.0400009155
170316810001,826,9,835,98.0,19.5100002289,80.4899978638
170316810002,821,0,821,100.0,11.8900003433,88.1100006104
170316810003,413,100,513,81.9499969482,24.5499992371,75.4499969482
170316810004,1074,28,1102,89.9599990845,0.0,100.0
170316811001,677,16,693,100.0,18.9300003052,81.0699996948
170316811002,732,0,732,100.0,11.0,89.0
170316811003,626,0,626,93.0199966431,8.60000038147,91.4000015259
170316811004,577,99,676,86.6699981689,28.7600002289,71.2399978638
170316811005,615,27,642,96.9800033569,22.7700004578,77.2300033569
170316812001,473,0,473,96.1399993896,13.1800003052,86.8199996948
170316812002,643,32,675,88.0100021362,12.2700004578,87.7300033569
170316812003,637,176,813,76.2699966431,33.0200004578,66.9800033569
170316812004,384,4,388,97.2399978638,11.5200004578,88.4800033569
170316813001,983,70,1053,93.1900024414,34.8499984741,65.1500015259
170316813002,879,152,1031,95.8199996948,38.7799987793,61.2200012207
170316813003,768,0,768,99.8700027466,10.0100002289,89.9899978638
170316814001,615,19,634,100.0,13.6999998093,86.3000030518
170316814002,787,21,808,97.5800018311,23.3500003815,76.6500015259
170316814003,901,133,1034,100.0,28.3299999237,71.6699981689
170316814004,728,41,769,100.0,40.1100006104,59.8899993896
170316903001,575,0,575,96.8000030518,15.9799995422,84.0199966431
170316903002,855,15,870,55.0299987793,12.279999733,87.7200012207
170316904001,654,37,691,92.6299972534,26.5799999237,73.4199981689
170316904002,991,0,991,96.6800003052,14.4099998474,85.5899963379
170316904003,712,0,712,88.2300033569,3.22000002861,96.7799987793
170316904004,766,29,795,87.75,13.0699996948,86.9300003052
170316905001,796,0,796,91.1800003052,7.69000005722,92.3099975586
170316909001,624,45,669,100.0,46.2700004578,53.7299995422
170316909002,617,0,617,100.0,2.48000001907,97.5199966431
170316909003,755,38,793,81.9199981689,0.0,100.0
170316909004,721,66,787,81.8899993896,14.9399995804,85.0599975586
170316909005,1165,130,1295,97.3000030518,36.8400001526,63.1599998474
170316910001,379,174,553,90.3600006104,56.6399993896,43.3600006104
170316910002,417,204,621,95.5400009155,52.3899993896,47.6100006104
170316910003,435,145,580,92.9499969482,30.9599990845,69.0400009155
170316910004,492,54,546,85.5800018311,5.86999988556,94.1299972534
170316911001,528,9,537,100.0,56.6399993896,43.3600006104
170316911002,689,60,749,93.8600006104,28.2399997711,71.7600021362
170316911003,632,51,683,100.0,12.8299999237,87.1699981689
170316911004,1061,58,1119,90.75,15.779999733,84.2200012207
170316912001,1195,117,1312,88.7699966431,19.4400005341,80.5599975586
170316912002,603,47,650,85.9800033569,25.6200008392,74.3799972534
170316912003,591,32,623,100.0,10.8500003815,89.1500015259
170316913001,981,207,1188,93.25,34.4799995422,65.5199966431
170316913002,927,187,1114,92.7600021362,27.2900009155,72.7099990845
170316914001,657,0,657,100.0,2.92000007629,97.0800018311
170316914002,772,0,772,100.0,0.0,100.0
170316914003,533,33,566,84.9800033569,0.0,100.0
170316914004,512,56,568,83.9000015259,10.1300001144,89.8700027466
170316914005,747,79,826,98.8000030518,38.6899986267,61.3100013733
170316915001,541,62,603,97.8899993896,6.88000011444,93.1200027466
170316915002,700,35,735,94.4700012207,17.1399993896,82.8600006104
170316915003,551,0,551,100.0,2.76999998093,97.2300033569
170317001001,1074,0,1074,48.0999984741,11.9499998093,88.0500030518
170317001002,1136,0,1136,93.3399963379,5.61999988556,94.3799972534
170317002001,674,3,677,44.7799987793,4.82000017166,95.1800003052
170317002002,1166,131,1297,80.7099990845,13.3100004196,86.6900024414
170317002003,1199,58,1257,68.8399963379,0.0,100.0
170317002004,1110,198,1308,79.7099990845,22.3799991608,77.6200027466
170317003011,1134,193,1327,74.3399963379,20.1499996185,79.8499984741
170317003012,694,0,694,41.0900001526,0.0,100.0
170317003013,1080,83,1163,51.4599990845,6.07999992371,93.9199981689
170317003021,968,100,1068,81.9000015259,13.5399999619,86.4599990845
170317003022,355,31,386,44.4199981689,10.8999996185,89.0999984741
170317003023,341,179,520,39.1599998474,35.6899986267,64.3099975586
170317003024,1328,20,1348,74.1900024414,1.40999996662,98.5899963379
170317004011,1738,167,1905,92.2099990845,15.9499998093,84.0500030518
170317004012,1117,70,1187,76.4300003052,19.0699996948,80.9300003052
170317004013,1151,169,1320,84.5599975586,7.34000015259,92.6600036621
170317004014,671,17,688,91.0100021362,5.11999988556,94.8799972534
170317004021,967,50,1017,97.1299972534,8.23999977112,91.7600021362
170317004022,991,148,1139,91.4100036621,25.2099990845,74.7900009155
170317004023,844,82,926,56.7700004578,21.3799991608,78.6200027466
170317005011,1041,30,1071,82.0100021362,1.92999994755,98.0699996948
170317005012,843,25,868,90.9899978638,40.8199996948,59.1800003052
170317005013,719,148,867,64.75,12.1199998856,87.8799972534
170317005014,1155,181,1336,77.4000015259,33.1100006104,66.8899993896
170317005015,761,68,829,97.4100036621,25.8299999237,74.1699981689
170317005016,722,231,953,100.0,30.0900001526,69.9100036621
170317005021,694,223,917,69.0999984741,92.0199966431,7.98000001907
170317005022,1398,156,1554,91.7399978638,18.3799991608,81.6200027466
170317101001,1192,0,1192,93.7799987793,0.0,100.0
170317102001,733,0,733,100.0,7.48000001907,92.5199966431
170317102002,719,33,752,71.2099990845,0.0,0.0
170317102003,658,0,658,65.8700027466,0.0,0.0
170317102004,796,0,796,94.4199981689,0.0,100.0
170317102005,1155,57,1212,84.7600021362,9.93999958038,90.0599975586
170317103001,1232,0,1232,84.8499984741,0.769999980927,99.2300033569
170317104001,680,0,680,100.0,5.65999984741,94.3399963379
170317104002,966,0,966,100.0,4.34999990463,95.6500015259
170317104003,748,19,767,80.1500015259,1.14999997616,98.8499984741
170317104004,308,43,351,46.8600006104,0.0,0.0
170317104005,1218,191,1409,97.4400024414,18.9400005341,81.0599975586
170317104006,650,112,762,84.3899993896,18.7800006866,81.2200012207
170317105001,1092,0,1092,100.0,0.0,100.0
170317105002,1113,0,1113,86.75,0.0,100.0
170317105003,594,16,610,81.1200027466,0.0,100.0
170317105004,994,16,1010,96.0999984741,16.1900005341,83.8099975586
170317106001,692,0,692,79.1800003052,10.4200000763,89.5800018311
170317106002,958,0,958,98.9700012207,0.0,100.0
170317107001,628,1,629,96.6200027466,17.5599994659,82.4400024414
170317107002,841,0,841,94.1800003052,3.1400001049,96.8600006104
170317107003,901,0,901,93.5599975586,8.64999961853,91.3499984741
170317107004,1038,0,1038,99.2399978638,8.60999965668,91.3899993896
170317108001,651,0,651,100.0,10.9099998474,89.0899963379
170317108002,761,0,761,100.0,1.14999997616,98.8499984741
170317108003,699,82,781,84.8899993896,31.3999996185,68.5999984741
170317108004,913,0,913,81.6600036621,4.15000009537,95.8499984741
170317108005,961,0,961,96.4899978638,3.01999998093,96.9800033569
170317108006,860,39,899,96.5599975586,12.1300001144,87.8700027466
170317109001,767,10,777,100.0,3.42000007629,96.5800018311
170317109002,982,423,1405,99.0100021362,34.6199989319,65.3799972534
170317110001,822,44,866,93.0199966431,22.6299991608,77.3700027466
170317110002,1441,70,1511,95.5100021362,18.5799999237,81.4199981689
170317110003,732,91,823,88.4899978638,18.0499992371,81.9499969482
170317111001,969,21,990,100.0,15.3299999237,84.6699981689
170317111002,812,0,812,86.3799972534,13.1400003433,86.8600006104
170317111003,788,36,824,90.25,18.9500007629,81.0500030518
170317112001,1307,43,1350,100.0,15.7700004578,84.2300033569
170317112002,1019,0,1019,100.0,6.19000005722,93.8099975586
170317112003,472,111,583,77.3199996948,23.2199993134,76.7799987793
170317112004,1947,72,2019,99.0199966431,24.0599994659,75.9400024414
170317113001,628,22,650,96.7300033569,6.90999984741,93.0899963379
170317113002,499,49,548,56.8499984741,9.15999984741,90.8399963379
170317114001,834,0,834,90.9499969482,5.75,94.25
170317114002,770,78,848,88.6999969482,15.2899999619,84.7099990845
170317114003,431,138,569,71.3000030518,30.1200008392,69.8799972534
170317115001,157,260,417,36.5099983215,65.8499984741,34.1500015259
170317115002,962,155,1117,80.9400024414,32.3899993896,67.6100006104
170317201001,687,0,687,73.3199996948,4.42999982834,95.5699996948
170317201002,491,112,603,41.7299995422,65.3799972534,34.6199989319
170317201003,419,38,457,50.1100006104,8.06999969482,91.9300003052
170317202001,693,0,693,73.9599990845,8.43999958038,91.5599975586
170317202002,600,47,647,58.7099990845,19.0400009155,80.9599990845
170317202003,585,360,945,46.5699996948,39.0800018311,60.9199981689
170317203001,207,13,220,25.4899997711,9.81999969482,90.1800003052
170317203002,601,18,619,85.8499984741,8.86999988556,91.1299972534
170317203003,690,236,926,66.7600021362,42.2999992371,57.7000007629
170317203004,382,0,382,49.0999984741,0.0,100.0
170317204001,636,10,646,86.25,10.2100000381,89.7900009155
170317204002,362,21,383,33.2799987793,10.8999996185,89.0999984741
170317205001,352,137,489,63.5099983215,48.3699989319,51.6300010681
170317205002,1058,0,1058,75.5199966431,3.11999988556,96.8799972534
170317206001,447,290,737,84.2300033569,49.2400016785,50.7599983215
170317206002,379,349,728,81.5199966431,59.0800018311,40.9199981689
170317207001,625,551,1176,74.0999984741,58.0400009155,41.9599990845
170317207002,499,340,839,97.7900009155,41.0800018311,58.9199981689
170317207003,86,337,423,60.3400001526,92.1100006104,7.88999986649
170317301001,221,34,255,33.0699996948,15.5900001526,84.4100036621
170317301002,622,22,644,91.0899963379,7.96000003815,92.0400009155
170317301003,552,29,581,60.9700012207,11.529999733,88.4700012207
170317302011,982,0,982,87.9899978638,6.78999996185,93.2099990845
170317302012,325,17,342,29.3099994659,6.90999984741,93.0899963379
170317302013,35,0,35,2.69000005722,0.0,0.0
170317302014,1297,64,1361,97.2099990845,3.90000009537,96.0999984741
170317302015,463,0,463,46.5299987793,0.0,100.0
170317302021,971,126,1097,96.2300033569,11.0200004578,88.9800033569
170317302022,694,22,716,62.6399993896,0.0,100.0
170317302023,771,0,771,96.7399978638,5.92000007629,94.0800018311
170317303001,1065,0,1065,90.1800003052,0.0,100.0
170317304001,731,13,744,90.7300033569,16.7999992371,83.1999969482
170317304002,839,283,1122,94.7600021362,28.6399993896,71.3600006104
170317304003,633,19,652,98.0500030518,45.4799995422,54.5200004578
170317304004,568,211,779,90.7900009155,16.2099990845,83.7900009155
170317305001,627,0,627,82.5,7.48000001907,92.5199966431
170317305002,491,56,547,69.3300018311,16.7900009155,83.2099990845
170317305003,929,34,963,83.8899993896,16.2600002289,83.7399978638
170317305004,1437,106,1543,89.7600021362,18.4599990845,81.5400009155
170317306001,734,62,796,100.0,25.0799999237,74.9199981689
170317306002,1297,58,1355,89.6200027466,51.0200004578,48.9799995422
170317306003,1084,149,1233,95.7300033569,20.1800003052,79.8199996948
170317307001,952,23,975,100.0,20.1200008392,79.8799972534
170317307002,875,296,1171,84.6100006104,38.6899986267,61.3100013733
170317401001,535,34,569,92.6699981689,17.0400009155,82.9599990845
170317401002,431,47,478,79.0100021362,12.220000267,87.7799987793
170317401003,353,178,531,79.1399993896,36.3400001526,63.6599998474
170317401004,1022,62,1084,96.4400024414,9.93000030518,90.0699996948
170317402001,1140,305,1445,59.8800010681,28.9200000763,71.0800018311
170317402002,441,3,444,33.2599983215,1.01999998093,98.9800033569
170317402003,347,107,454,35.3300018311,28.5,71.5
170317402004,1034,155,1189,78.8499984741,21.8299999237,78.1699981689
170317403001,819,0,819,86.5800018311,11.1300001144,88.8700027466
170317403002,793,49,842,72.2099990845,10.6899995804,89.3099975586
170317403003,541,33,574,70.5199966431,10.0100002289,89.9899978638
170317403004,0,0,0,0.0,0.0,0.0
170317403005,319,151,470,48.6500015259,31.2900009155,68.7099990845
170317404001,851,28,879,100.0,8.82999992371,91.1699981689
170317404002,591,170,761,78.6999969482,31.2999992371,68.6999969482
170317404003,1221,228,1449,65.8000030518,34.8499984741,65.1500015259
170317404004,479,72,551,74.5599975586,16.5499992371,83.4499969482
170317501001,880,76,956,92.9100036621,16.8799991608,83.1200027466
170317501002,392,223,615,69.4100036621,49.6300010681,50.3699989319
170317501003,739,111,850,97.5899963379,41.3100013733,58.6899986267
170317501004,874,221,1095,80.8099975586,20.6000003815,79.4000015259
170317502001,521,145,666,88.0999984741,42.7000007629,57.2999992371
170317502002,473,128,601,68.5299987793,31.6499996185,68.3499984741
170317502003,311,293,604,80.6399993896,70.7699966431,29.2299995422
170317502004,478,244,722,84.9400024414,36.25,63.75
170317503001,384,30,414,57.0999984741,5.69000005722,94.3099975586
170317503002,807,47,854,93.3300018311,20.7000007629,79.3000030518
170317503003,262,22,284,32.0499992371,11.2100000381,88.7900009155
170317504001,1016,171,1187,78.25,29.4400005341,70.5599975586
170317504002,835,0,835,100.0,25.1800003052,74.8199996948
170317504003,311,269,580,81.8099975586,59.8100013733,40.1899986267
170317505001,1413,276,1689,93.0100021362,32.8499984741,67.1500015259
170317505002,443,208,651,86.9199981689,57.8699989319,42.1300010681
170317505003,1660,145,1805,89.5800018311,25.7299995422,74.2699966431
170317505004,1187,139,1326,97.3600006104,20.5,79.5
170317506001,813,186,999,86.7200012207,21.7999992371,78.1999969482
170317506002,671,151,822,100.0,19.9200000763,80.0800018311
170317506003,480,127,607,72.0899963379,21.0900001526,78.9100036621
170317506004,712,73,785,90.9599990845,20.0799999237,79.9199981689
170317608011,1218,739,1957,84.0599975586,36.0900001526,63.9099998474
170317608012,870,248,1118,65.0,21.6100006104,78.3899993896
170317608021,1833,263,2096,87.4100036621,72.5899963379,27.4099998474
170317608031,810,472,1282,90.4700012207,56.4900016785,43.5099983215
170317608032,1406,264,1670,91.6100006104,68.4899978638,31.5100002289
170317608033,792,629,1421,87.7200012207,46.0,54.0
170317608034,1024,235,1259,93.1900024414,24.5799999237,75.4199981689
170317702011,462,324,786,63.2900009155,71.8600006104,28.1399993896
170317702012,693,436,1129,53.1300010681,42.8100013733,57.1899986267
170317702013,2095,272,2367,92.8199996948,19.7099990845,80.2900009155
170317702021,849,592,1441,85.8199996948,53.3400001526,46.6599998474
170317702022,105,387,492,25.5900001526,20.2999992371,79.6999969482
170317702023,455,479,934,71.6800003052,58.9000015259,41.0999984741
170317703001,335,407,742,77.1299972534,56.7999992371,43.2000007629
170317703002,880,287,1167,76.5699996948,36.0800018311,63.9199981689
170317703003,488,134,622,42.8100013733,17.5799999237,82.4199981689
170317703004,408,651,1059,57.0600013733,81.6600036621,18.3400001526
170317703005,564,343,907,59.8699989319,78.5299987793,21.4699993134
170317704001,537,855,1392,95.7399978638,24.9899997711,75.0100021362
170317704002,825,674,1499,85.2200012207,62.7000007629,37.2999992371
170317704003,562,265,827,63.9599990845,23.4899997711,76.5100021362
170317705001,2187,338,2525,73.5299987793,21.1599998474,78.8399963379
170317705002,396,96,492,76.4000015259,13.3400001526,86.6600036621
170317706011,579,327,906,86.9499969482,44.6599998474,55.3400001526
170317706012,650,457,1107,87.4400024414,53.4900016785,46.5099983215
170317706013,343,430,773,81.4499969482,44.2299995422,55.7700004578
170317706021,959,481,1440,75.0,33.9000015259,66.0999984741
170317706022,1635,0,1635,98.6100006104,14.8800001144,85.1200027466
170317706023,777,360,1137,80.6399993896,40.4799995422,59.5200004578
170317707001,809,0,809,92.9899978638,27.4400005341,72.5599975586
170317707002,1313,83,1396,77.1699981689,11.2899999619,88.7099990845
170317708001,2160,92,2252,86.1200027466,52.2400016785,47.7599983215
170317708002,2119,633,2752,92.7799987793,25.0400009155,74.9599990845
170317709011,348,516,864,75.5199966431,65.8600006104,34.1399993896
170317709012,804,186,990,92.4400024414,26.9799995422,73.0199966431
170317709013,749,33,782,88.8600006104,13.9300003052,86.0699996948
170317709014,1232,195,1427,77.1399993896,21.1900005341,78.8099975586
170317709021,1268,349,1617,92.5599975586,41.5200004578,58.4799995422
170317709022,1581,54,1635,91.9100036621,12.5100002289,87.4899978638
170318001001,221,720,941,94.6699981689,96.4000015259,3.59999990463
170318001002,322,1076,1398,99.2900009155,95.2900009155,4.71000003815
170318002001,366,842,1208,98.0500030518,86.0899963379,13.9099998474
170318002002,219,642,861,68.6600036621,77.9599990845,22.0400009155
170318002003,128,364,492,60.1500015259,88.9700012207,11.029999733
170318002004,187,132,319,35.2099990845,66.0699996948,33.9300003052
170318002005,313,733,1046,87.6800003052,87.5699996948,12.4300003052
170318002006,21,123,144,15.5,61.1899986267,38.8100013733
170318003001,624,478,1102,93.1500015259,63.2799987793,36.7200012207
170318003002,195,191,386,61.1699981689,74.1100006104,25.8899993896
170318003003,182,1114,1296,75.6600036621,87.6900024414,12.3100004196
170318004001,277,915,1192,100.0,97.0999984741,2.90000009537
170318004002,338,1142,1480,95.6699981689,95.5,4.5
170318004003,509,436,945,93.0100021362,79.8799972534,20.1200008392
170318005001,661,120,781,97.1399993896,62.6399993896,37.3600006104
170318005002,330,585,915,95.0199966431,89.1800003052,10.8199996948
170318005003,144,639,783,83.4800033569,90.6500015259,9.35000038147
170318005004,251,720,971,78.6900024414,79.0500030518,20.9500007629
170318005005,148,115,263,27.3400001526,81.6699981689,18.3299999237
170318006001,270,721,991,70.4800033569,85.5400009155,14.4600000381
170318006002,611,387,998,100.0,67.8300018311,32.1699981689
170318007001,51,163,214,26.1900005341,94.1800003052,5.82000017166
170318007002,436,806,1242,58.6699981689,75.1500015259,24.8500003815
170318007003,73,265,338,39.4399986267,93.9100036621,6.09000015259
170318007004,546,560,1106,79.9700012207,63.25,36.75
170318008001,1115,905,2020,91.3199996948,65.5400009155,34.4599990845
170318009001,348,663,1011,76.8199996948,85.5100021362,14.4899997711
170318009002,488,272,760,96.0800018311,66.6999969482,33.2999992371
170318009003,502,584,1086,87.5100021362,68.3799972534,31.6200008392
170318009004,444,559,1003,94.2699966431,52.75,47.25
170318010001,412,360,772,100.0,70.4000015259,29.6000003815
170318010002,390,627,1017,87.0699996948,79.5,20.5
170318010003,489,895,1384,96.0400009155,82.8700027466,17.1299991608
170318010004,334,942,1276,82.6999969482,87.9499969482,12.0500001907
170318011001,353,387,740,96.9899978638,71.7900009155,28.2099990845
170318011002,823,211,1034,99.6100006104,36.9900016785,63.0099983215
170318011003,329,634,963,72.6200027466,77.75,22.25
170318011004,544,938,1482,94.4599990845,76.0299987793,23.9699993134
170318012001,371,374,745,56.1800003052,58.8100013733,41.1899986267
170318012002,77,478,555,71.8000030518,93.4599990845,6.53999996185
170318012003,373,1038,1411,98.9499969482,90.7300033569,9.27000045776
170318013001,125,253,378,41.8100013733,67.7699966431,32.2299995422
170318013002,0,45,45,4.19000005722,0.0,0.0
170318013003,234,133,367,42.0900001526,0.0,0.0
170318013004,832,548,1380,96.9800033569,70.8799972534,29.1200008392
170318014001,402,738,1140,75.8499984741,79.1600036621,20.8400001526
170318014002,519,788,1307,92.5599975586,83.6600036621,16.3400001526
170318015001,1333,570,1903,81.9199981689,25.1900005341,74.8099975586
170318015002,414,943,1357,71.6500015259,89.7099990845,10.2899999619
170318015003,889,700,1589,93.9100036621,67.7900009155,32.2099990845
170318016011,1532,618,2150,88.0100021362,25.5699996948,74.4300003052
170318016012,664,349,1013,56.5,39.9099998474,60.0900001526
170318016031,787,211,998,66.1800003052,50.9900016785,49.0099983215
170318016032,2166,80,2246,96.3099975586,27.6100006104,72.3899993896
170318016051,565,651,1216,86.3600006104,62.75,37.25
170318016052,312,495,807,95.2799987793,78.7799987793,21.2199993134
170318016053,549,621,1170,72.3600006104,70.1500015259,29.8500003815
170318016054,457,387,844,83.9000015259,66.0299987793,33.9700012207
170318016055,449,160,609,81.6399993896,34.1199989319,65.8799972534
170318016061,197,631,828,88.8399963379,89.4800033569,10.5200004578
170318016062,285,783,1068,83.8300018311,86.3700027466,13.6300001144
170318016063,796,335,1131,85.3600006104,48.2599983215,51.7400016785
170318016064,124,330,454,71.1600036621,77.8799972534,22.1200008392
170318016065,624,579,1203,62.7900009155,53.8400001526,46.1599998474
170318016071,663,716,1379,80.3600006104,60.9300003052,39.0699996948
170318016072,618,246,864,87.4499969482,28.0799999237,71.9199981689
170318016073,1682,573,2255,86.0400009155,44.7999992371,55.2000007629
170318016081,760,686,1446,81.2799987793,36.1399993896,63.8600006104
170318016082,590,400,990,67.7600021362,64.2399978638,35.7599983215
170318016083,306,147,453,64.1600036621,49.4199981689,50.5800018311
170318016084,220,776,996,38.4099998474,70.3399963379,29.6599998474
170318017011,533,1020,1553,70.7200012207,79.5500030518,20.4500007629
170318017012,278,809,1087,70.4899978638,85.0,15.0
170318017021,104,582,686,51.1599998474,92.2900009155,7.71000003815
170318017022,233,352,585,48.9900016785,40.9199981689,59.0800018311
170318017023,739,493,1232,85.9100036621,45.0499992371,54.9500007629
170318017024,195,167,362,54.5200004578,68.3899993896,31.6100006104
170318018001,669,696,1365,90.9400024414,58.3899993896,41.6100006104
170318018002,444,523,967,84.1600036621,72.9400024414,27.0599994659
170318018003,452,1007,1459,87.0500030518,87.5999984741,12.3999996185
170318018004,492,396,888,69.1100006104,68.4700012207,31.5300006866
170318019011,564,577,1141,56.6300010681,52.8400001526,47.1599998474
170318019012,629,358,987,66.4199981689,19.7299995422,80.2699966431
170318019013,420,129,549,61.4099998474,30.6599998474,69.3399963379
170318019021,318,476,794,84.1999969482,68.0,32.0
170318019022,138,570,708,52.9900016785,89.5599975586,10.4399995804
170318019023,417,184,601,65.1800003052,39.8899993896,60.1100006104
170318020021,858,1318,2176,85.2699966431,78.0599975586,21.9400005341
170318020022,782,1057,1839,75.6800003052,74.8899993896,25.1100006104
170318020031,662,807,1469,52.7799987793,73.0100021362,26.9899997711
170318020041,385,272,657,93.7200012207,65.0199966431,34.9799995422
170318020042,1292,132,1424,96.5400009155,37.1899986267,62.8100013733
170318020043,1164,233,1397,94.2600021362,26.2299995422,73.7699966431
170318020044,1214,515,1729,99.1399993896,40.6599998474,59.3400001526
170318021001,164,354,518,66.0699996948,76.5899963379,23.4099998474
170318021002,384,439,823,93.4199981689,78.0599975586,21.9400005341
170318021003,639,1083,1722,90.9199981689,84.0400009155,15.9600000381
170318022001,301,717,1018,80.5400009155,90.2300033569,9.77000045776
170318022002,661,620,1281,87.6800003052,67.7900009155,32.2099990845
170318022003,532,775,1307,77.5199966431,75.3099975586,24.6900005341
170318023001,2343,289,2632,54.3699989319,8.34000015259,91.6600036621
170318024021,189,19,208,14.3500003815,16.75,83.25
170318024022,462,344,806,72.0299987793,74.9499969482,25.0499992371
170318024023,881,128,1009,89.9300003052,9.97000026703,90.0299987793
170318024024,400,144,544,47.8499984741,32.6399993896,67.3600006104
170318024031,328,616,944,67.3799972534,65.4800033569,34.5200004578
170318024041,956,868,1824,95.0999984741,51.7599983215,48.2400016785
170318024042,1086,898,1984,87.0899963379,41.1599998474,58.8400001526
170318024043,491,159,650,69.2200012207,35.5099983215,64.4899978638
170318024044,1115,463,1578,76.9800033569,37.7299995422,62.2700004578
170318025031,769,243,1012,87.8499984741,43.5699996948,56.4300003052
170318025032,796,494,1290,74.1399993896,49.5800018311,50.4199981689
170318025033,533,668,1201,50.5,65.9899978638,34.0099983215
170318025034,216,406,622,69.1900024414,53.3600006104,46.6399993896
170318025041,792,476,1268,82.5,42.3699989319,57.6300010681
170318025042,800,413,1213,87.5199966431,53.1300010681,46.8699989319
170318025043,1325,627,1952,87.4599990845,29.9699993134,70.0299987793
170318025044,425,497,922,64.3899993896,65.6200027466,34.3800010681
170318025051,2172,387,2559,98.6100006104,18.8099994659,81.1900024414
170318025052,201,213,414,58.5600013733,49.5900001526,50.4099998474
170318025053,2866,342,3208,92.7399978638,11.8100004196,88.1900024414
170318025061,947,351,1298,86.0699996948,60.1199989319,39.8800010681
170318025062,492,307,799,82.2900009155,70.2900009155,29.7099990845
170318026051,198,378,576,40.7900009155,61.1399993896,38.8600006104
170318026052,716,428,1144,79.4400024414,38.2599983215,61.7400016785
170318026053,617,610,1227,93.7399978638,61.7200012207,38.2799987793
170318026054,673,352,1025,78.4800033569,49.2900009155,50.7099990845
170318026055,724,484,1208,90.9599990845,39.25,60.75
170318026071,644,664,1308,89.0400009155,74.5599975586,25.4400005341
170318026081,939,678,1617,88.1200027466,58.5900001526,41.4099998474
170318026082,1152,974,2126,88.4400024414,62.3800010681,37.6199989319
170318026083,567,406,973,90.9300003052,66.9499969482,33.0499992371
170318026084,472,382,854,92.3199996948,66.4000015259,33.5999984741
170318026091,1570,8,1578,70.7300033569,11.529999733,88.4700012207
170318026092,969,0,969,91.0699996948,0.0,100.0
170318026093,0,0,0,0.0,0.0,0.0
170318026094,350,266,616,27.1200008392,28.6200008392,71.3799972534
170318026101,491,466,957,56.1300010681,76.2099990845,23.7900009155
170318027011,1271,598,1869,73.7300033569,41.5099983215,58.4900016785
170318027012,662,582,1244,80.1500015259,63.0,37.0
170318027013,354,352,706,74.3199996948,52.1300010681,47.8699989319
170318027014,749,773,1522,80.3199996948,54.5099983215,45.4900016785
170318027021,404,392,796,47.1599998474,51.6199989319,48.3800010681
170318027022,955,564,1519,74.9000015259,65.9100036621,34.0900001526
170318027023,185,298,483,62.1599998474,66.4899978638,33.5099983215
170318028011,337,617,954,88.9899978638,80.5699996948,19.4300003052
170318028012,279,543,822,76.1800003052,60.5499992371,39.4500007629
170318028013,320,560,880,97.3499984741,80.0500030518,19.9500007629
170318028014,409,434,843,90.5500030518,60.8899993896,39.1100006104
170318028015,147,444,591,73.2300033569,73.3799972534,26.6200008392
170318028021,668,433,1101,84.1699981689,48.3600006104,51.6399993896
170318028022,449,354,803,58.4000015259,47.0800018311,52.9199981689
170318028023,324,599,923,60.3300018311,79.9700012207,20.0300006866
170318028024,682,410,1092,91.2300033569,54.6599998474,45.3400001526
170318028025,758,257,1015,85.6500015259,36.0,64.0
170318029001,498,372,870,91.2900009155,57.3100013733,42.6899986267
170318029002,454,986,1440,82.9499969482,63.5099983215,36.4900016785
170318029003,327,817,1144,58.5800018311,89.3000030518,10.6999998093
170318029004,545,682,1227,84.8000030518,61.0999984741,38.9000015259
170318030051,220,523,743,69.6299972534,86.1699981689,13.8299999237
170318030052,618,287,905,56.1399993896,40.3899993896,59.6100006104
170318030071,343,235,578,39.5600013733,48.5999984741,51.4000015259
170318030072,655,357,1012,64.7099990845,53.9099998474,46.0900001526
170318030073,587,473,1060,47.2200012207,57.7999992371,42.2000007629
170318030081,651,451,1102,66.0699996948,50.5,49.5
170318030082,276,472,748,68.3099975586,79.2099990845,20.7900009155
170318030083,748,587,1335,68.7099990845,59.9199981689,40.0800018311
170318030101,376,221,597,62.3199996948,65.75,34.25
170318030102,169,275,444,54.5499992371,51.4399986267,48.5600013733
170318030103,427,251,678,62.2599983215,61.4300003052,38.5699996948
170318030104,406,983,1389,58.9300003052,75.4100036621,24.5900001526
170318030121,486,660,1146,51.2099990845,39.4099998474,60.5900001526
170318030131,540,872,1412,61.2299995422,61.7599983215,38.2400016785
170318030132,280,397,677,33.0099983215,56.4500007629,43.5499992371
170318030133,479,214,693,63.9900016785,42.5200004578,57.4799995422
170318030141,827,1055,1882,90.0,52.4399986267,47.5600013733
170318030142,390,751,1141,86.8300018311,78.5500030518,21.4500007629
170318030151,474,949,1423,78.4000015259,73.6900024414,26.3099994659
170318030152,326,514,840,61.2700004578,64.4400024414,35.5600013733
170318030153,624,398,1022,81.1800003052,51.2599983215,48.7400016785
170318030161,1042,755,1797,89.8499984741,57.0800018311,42.9199981689
170318030171,1116,712,1828,96.0100021362,59.4700012207,40.5299987793
170318030172,1479,293,1772,82.7300033569,22.1100006104,77.8899993896
170318030173,1158,281,1439,72.2399978638,17.1299991608,82.8700027466
170318031001,702,872,1574,81.2600021362,71.8499984741,28.1499996185
170318031002,162,318,480,31.8899993896,73.3199996948,26.6800003052
170318032001,578,1124,1702,90.7200012207,83.1100006104,16.8899993896
170318032002,851,1278,2129,86.0500030518,63.8400001526,36.1599998474
170318032003,794,357,1151,92.6699981689,44.0200004578,55.9799995422
170318033001,1078,963,2041,96.1800003052,69.3000030518,30.7000007629
170318033002,1545,139,1684,100.0,26.2099990845,73.7900009155
170318033003,1376,285,1661,95.7900009155,48.0400009155,51.9599990845
170318034001,470,405,875,96.0500030518,62.2599983215,37.7400016785
170318034002,427,448,875,99.3199996948,83.25,16.75
170318034003,463,79,542,54.3600006104,11.5699996948,88.4300003052
170318034004,1040,111,1151,76.8899993896,20.25,79.75
170318034005,400,371,771,83.7099990845,65.0,35.0
170318034006,773,246,1019,88.1500015259,29.8999996185,70.0999984741
170318035001,287,174,461,54.1100006104,100.0,0.0
170318035002,158,218,376,37.3800010681,0.0,0.0
170318035003,635,734,1369,90.9000015259,56.6899986267,43.3100013733
170318035004,225,694,919,63.1599998474,86.9000015259,13.1000003815
170318035005,129,356,485,47.9700012207,62.2700004578,37.7299995422
170318036031,745,504,1249,64.6800003052,73.2699966431,26.7299995422
170318036032,302,501,803,74.6999969482,77.7900009155,22.2099990845
170318036033,916,243,1159,44.8499984741,45.75,54.25
170318036034,101,254,355,30.3899993896,78.8099975586,21.1900005341
170318036041,537,321,858,81.8700027466,55.3499984741,44.6500015259
170318036042,626,200,826,67.9800033569,31.0799999237,68.9199981689
170318036043,254,325,579,48.0900001526,57.0499992371,42.9500007629
170318036044,140,529,669,78.25,53.7700004578,46.2299995422
170318036051,488,271,759,44.6199989319,28.1399993896,71.8600006104
170318036052,225,394,619,52.0200004578,57.4199981689,42.5800018311
170318036053,35,0,35,2.66000008583,0.0,0.0
170318036054,1208,354,1562,50.4000015259,29.5300006866,70.4700012207
170318036061,1890,43,1933,100.0,4.28000020981,95.7200012207
170318036062,1249,27,1276,60.2200012207,7.55999994278,92.4400024414
170318036063,1696,868,2564,93.5400009155,34.7999992371,65.1999969482
170318036064,661,412,1073,75.25,25.7900009155,74.2099990845
170318036071,0,0,0,0.0,0.0,0.0
170318036072,0,0,0,0.0,0.0,0.0
170318036073,973,304,1277,61.0699996948,28.8299999237,71.1699981689
170318036074,161,251,412,33.3600006104,67.5699996948,32.4300003052
170318036081,642,844,1486,61.6100006104,68.3600006104,31.6399993896
170318036082,1423,791,2214,82.6699981689,54.0099983215,45.9900016785
170318036083,1692,142,1834,79.4300003052,18.5900001526,81.4100036621
170318036101,636,421,1057,65.0500030518,35.8800010681,64.1200027466
170318036102,53,39,92,11.1700000763,0.0,0.0
170318036103,1087,571,1658,85.9499969482,52.2799987793,47.7200012207
170318036104,1784,546,2330,81.6399993896,27.5200004578,72.4800033569
170318036111,327,218,545,97.8499984741,37.6500015259,62.3499984741
170318036112,76,7,83,5.19999980927,0.0,100.0
170318036113,226,238,464,28.3999996185,0.0,0.0
170318036114,448,0,448,63.6399993896,19.8400001526,80.1600036621
170318036115,348,1133,1481,92.2699966431,83.5599975586,16.4400005341
170318036121,2008,103,2111,95.1299972534,14.5699996948,85.4300003052
170318036122,295,829,1124,84.9599990845,74.5800018311,25.4200000763
170318037011,477,446,923,79.0199966431,41.2799987793,58.7200012207
170318037012,626,161,787,51.2999992371,32.1699981689,67.8300018311
170318037021,479,273,752,84.6800003052,44.0800018311,55.9199981689
170318037022,452,498,950,46.5499992371,61.7700004578,38.2299995422
170318037023,565,541,1106,65.6800003052,68.8000030518,31.2000007629
170318037024,815,354,1169,70.1299972534,36.3499984741,63.6500015259
170318038001,539,126,665,55.8400001526,27.8600006104,72.1399993896
170318038002,551,154,705,87.3600006104,23.8899993896,76.1100006104
170318038003,1036,557,1593,94.8199996948,46.8400001526,53.1599998474
170318038004,577,306,883,89.0100021362,47.1300010681,52.8699989319
170318039011,494,524,1018,58.1399993896,38.4199981689,61.5800018311
170318039012,1279,300,1579,89.8700027466,31.9400005341,68.0599975586
170318039021,167,462,629,59.9000015259,73.6600036621,26.3400001526
170318039022,160,628,788,69.1800003052,89.3499984741,10.6499996185
170318039023,341,538,879,66.9499969482,70.1999969482,29.7999992371
170318040001,290,640,930,53.7599983215,65.1200027466,34.8800010681
170318040002,1147,834,1981,68.7399978638,58.4799995422,41.5200004578
170318041021,387,1102,1489,64.6800003052,81.8700027466,18.1299991608
170318041022,664,784,1448,67.3799972534,76.6600036621,23.3400001526
170318041023,1081,1010,2091,80.7300033569,42.1800003052,57.8199996948
170318041041,471,181,652,37.7299995422,57.1399993896,42.8600006104
170318041042,232,240,472,24.8600006104,40.4099998474,59.5900001526
170318041043,0,0,0,0.0,0.0,0.0
170318041051,351,93,444,27.1599998474,43.2799987793,56.7200012207
170318041052,111,63,174,11.720000267,28.3600006104,71.6399993896
170318041053,140,185,325,36.7200012207,68.1399993896,31.8600006104
170318041061,796,823,1619,81.8499984741,69.7399978638,30.2600002289
170318041062,1191,343,1534,93.8799972534,47.2099990845,52.7900009155
170318041063,730,186,916,57.5,15.8599996567,84.1399993896
170318041064,624,196,820,46.2000007629,60.8499984741,39.1500015259
170318041081,196,473,669,47.0499992371,86.2200012207,13.779999733
170318041082,1116,901,2017,82.2300033569,62.0400009155,37.9599990845
170318041091,255,406,661,54.9900016785,64.9199981689,35.0800018311
170318041092,661,682,1343,77.9000015259,73.7399978638,26.2600002289
170318042011,397,658,1055,52.8600006104,78.2200012207,21.7800006866
170318042012,1249,703,1952,68.7799987793,69.5699996948,30.4300003052
170318042013,339,279,618,32.2400016785,37.2000007629,62.7999992371
170318042014,360,427,787,54.9199981689,58.6300010681,41.3699989319
170318042021,553,81,634,98.4499969482,23.8700008392,76.1299972534
170318042022,767,570,1337,46.9300003052,64.8899993896,35.1100006104
170318042023,306,348,654,78.6100006104,69.4100036621,30.5900001526
170318042024,469,735,1204,38.0999984741,43.1500015259,56.8499984741
170318043051,428,134,562,32.0600013733,25.5799999237,74.4199981689
170318043052,611,606,1217,81.6800003052,50.9199981689,49.0800018311
170318043053,661,412,1073,68.6900024414,45.5099983215,54.4900016785
170318043054,984,953,1937,81.25,59.9099998474,40.0900001526
170318043061,777,959,1736,70.8000030518,68.5500030518,31.4500007629
170318043062,0,0,0,0.0,0.0,0.0
170318043063,0,0,0,0.0,0.0,0.0
170318043064,183,353,536,43.2599983215,64.7099990845,35.2900009155
170318043081,254,772,1026,50.8400001526,77.6699981689,22.3299999237
170318043082,137,107,244,10.8500003815,29.0100002289,70.9899978638
170318043083,404,788,1192,99.9199981689,56.4599990845,43.5400009155
170318043091,367,635,1002,47.7400016785,63.7999992371,36.2000007629
170318043092,274,62,336,30.7999992371,14.5799999237,85.4199981689
170318043101,961,300,1261,52.2599983215,39.2700004578,60.7299995422
170318043102,1260,726,1986,66.9800033569,41.1300010681,58.8699989319
170318043103,1159,577,1736,79.6299972534,43.4000015259,56.5999984741
170318043104,580,405,985,64.0,59.2900009155,40.7099990845
170318043111,1460,291,1751,75.4400024414,39.8300018311,60.1699981689
170318043112,2929,475,3404,58.6699981689,13.720000267,86.2799987793
170318044031,396,31,427,36.3699989319,4.61999988556,95.3799972534
170318044032,1096,544,1640,99.4499969482,57.0,43.0
170318044033,1203,1160,2363,60.5900001526,55.6899986267,44.3100013733
170318044041,238,531,769,55.5200004578,79.6299972534,20.3700008392
170318044042,304,475,779,63.5900001526,65.4800033569,34.5200004578
170318044043,922,411,1333,83.8399963379,49.7200012207,50.2799987793
170318044044,360,238,598,57.6100006104,47.0400009155,52.9599990845
170318044051,1588,385,1973,90.9599990845,32.2999992371,67.6999969482
170318044052,969,447,1416,94.0899963379,35.0900001526,64.9100036621
170318044061,1507,635,2142,81.7200012207,49.0499992371,50.9500007629
170318044062,1178,463,1641,79.8199996948,24.1599998474,75.8399963379
170318044063,712,233,945,60.5400009155,25.7399997711,74.2600021362
170318045051,439,342,781,77.5599975586,42.8499984741,57.1500015259
170318045052,365,495,860,74.1999969482,35.2000007629,64.8000030518
170318045053,1115,499,1614,95.2799987793,42.0099983215,57.9900016785
170318045061,390,402,792,63.6699981689,47.7999992371,52.2000007629
170318045062,406,402,808,56.1899986267,68.8499984741,31.1499996185
170318045063,1217,662,1879,67.5199966431,37.1399993896,62.8600006104
170318045071,412,41,453,11.3400001526,26.6299991608,73.3700027466
170318045072,1461,613,2074,54.0400009155,26.75,73.25
170318045073,2081,612,2693,68.4499969482,41.6699981689,58.3300018311
170318045074,162,98,260,34.9000015259,16.9099998474,83.0899963379
170318045081,1190,473,1663,73.5800018311,46.0299987793,53.9700012207
170318045091,207,188,395,32.6199989319,56.6100006104,43.3899993896
170318045092,529,94,623,38.7200012207,18.6200008392,81.3799972534
170318045093,578,0,578,34.8400001526,0.0,100.0
170318045094,272,88,360,19.3299999237,28.7999992371,71.1999969482
170318045101,789,125,914,72.1399993896,26.7800006866,73.2200012207
170318045102,516,415,931,83.4199981689,43.4900016785,56.5099983215
170318045103,1567,547,2114,87.4599990845,49.1699981689,50.8300018311
170318045104,70,383,453,36.5600013733,96.6800003052,3.31999993324
170318045111,1584,65,1649,95.4800033569,18.4099998474,81.5899963379
170318045112,532,101,633,95.1900024414,35.3300018311,64.6699981689
170318046031,2095,437,2532,92.5800018311,20.8600006104,79.1399993896
170318046032,954,77,1031,82.3499984741,16.3099994659,83.6900024414
170318046033,923,593,1516,87.5299987793,29.9300003052,70.0699996948
170318046061,415,266,681,77.4700012207,34.0499992371,65.9499969482
170318046062,1063,1036,2099,84.7399978638,58.0299987793,41.9700012207
170318046063,579,318,897,70.0199966431,39.0,61.0
170318046064,833,831,1664,67.4499969482,54.6699981689,45.3300018311
170318046071,1287,434,1721,85.4100036621,43.5299987793,56.4700012207
170318046072,1446,325,1771,84.3700027466,24.6000003815,75.4000015259
170318046073,1028,280,1308,83.3700027466,28.0200004578,71.9800033569
170318046074,848,139,987,75.0599975586,10.1899995804,89.8099975586
170318046081,366,443,809,58.9199981689,54.3300018311,45.6699981689
170318046082,289,436,725,86.6200027466,78.0699996948,21.9300003052
170318046083,810,443,1253,80.3199996948,60.5299987793,39.4700012207
170318046091,784,1090,1874,74.6299972534,61.2599983215,38.7400016785
170318046092,431,954,1385,89.9400024414,52.1199989319,47.8800010681
170318046093,704,687,1391,88.2099990845,52.1500015259,47.8499984741
170318046101,703,728,1431,84.5199966431,64.7699966431,35.2299995422
170318046102,188,186,374,58.1599998474,66.4800033569,33.5200004578
170318046111,791,351,1142,77.1600036621,41.3800010681,58.6199989319
170318046112,464,689,1153,66.2300033569,60.7000007629,39.2999992371
170318046113,443,279,722,63.3899993896,51.7700004578,48.2299995422
170318047011,670,664,1334,96.25,38.8800010681,61.1199989319
170318047012,562,313,875,63.0400009155,28.9899997711,71.0100021362
170318047013,1577,529,2106,93.3899993896,42.6800003052,57.3199996948
170318047014,1130,660,1790,95.1100006104,15.6000003815,84.4000015259
170318047051,654,282,936,79.4599990845,62.9399986267,37.0600013733
170318047052,1393,263,1656,97.5299987793,43.0099983215,56.9900016785
170318047053,511,447,958,89.7799987793,63.4900016785,36.5099983215
170318047061,754,234,988,68.8499984741,36.7099990845,63.2900009155
170318047062,409,476,885,86.8499984741,46.7900009155,53.2099990845
170318047091,896,404,1300,100.0,31.6200008392,68.3799972534
170318047092,930,389,1319,90.8399963379,50.0,50.0
170318047093,253,471,724,64.8199996948,64.3399963379,35.6599998474
170318047094,528,458,986,72.0199966431,59.6800003052,40.3199996948
170318047095,192,132,324,25.0599994659,45.8800010681,54.1199989319
170318047101,472,232,704,61.7000007629,37.4900016785,62.5099983215
170318047102,369,386,755,64.4199981689,65.2600021362,34.7400016785
170318047103,454,132,586,47.4900016785,21.6700000763,78.3300018311
170318047104,299,249,548,69.3700027466,62.3100013733,37.6899986267
170318047111,1724,373,2097,83.25,22.7000007629,77.3000030518
170318047112,294,557,851,82.8600006104,76.8399963379,23.1599998474
170318047113,669,725,1394,50.25,53.3400001526,46.6599998474
170318047114,79,412,491,41.2599983215,82.8199996948,17.1800003052
170318047121,397,997,1394,67.4100036621,76.8099975586,23.1900005341
170318047122,394,255,649,65.8899993896,56.9000015259,43.0999984741
170318047123,681,488,1169,50.4099998474,41.3499984741,58.6500015259
170318047131,942,86,1028,73.1699981689,8.22000026703,91.7799987793
170318047132,1025,210,1235,64.5599975586,19.3999996185,80.5999984741
170318047133,63,223,286,44.3400001526,88.4599990845,11.5399999619
170318047134,289,131,420,58.0900001526,30.0499992371,69.9499969482
170318047141,622,370,992,95.3799972534,47.8300018311,52.1699981689
170318047142,772,409,1181,98.0899963379,43.1399993896,56.8600006104
170318047143,969,200,1169,95.0400009155,27.0,73.0
170318047151,1369,355,1724,93.3399963379,54.6899986267,45.3100013733
170318047152,1356,82,1438,98.7600021362,19.6700000763,80.3300018311
170318047161,1093,178,1271,77.2200012207,32.4300003052,67.5699996948
170318047162,1766,437,2203,96.3300018311,36.1100006104,63.8899993896
170318047163,1220,343,1563,100.0,60.3899993896,39.6100006104
170318048031,666,259,925,75.7600021362,22.5300006866,77.4700012207
170318048032,388,520,908,63.3600006104,50.2200012207,49.7799987793
170318048033,1213,972,2185,78.9100036621,51.8600006104,48.1399993896
170318048041,219,272,491,37.1399993896,51.9199981689,48.0800018311
170318048042,975,425,1400,53.0099983215,32.0900001526,67.9100036621
170318048043,133,474,607,65.1999969482,52.2999992371,47.7000007629
170318048044,1289,163,1452,88.0500030518,30.1100006104,69.8899993896
170318048051,782,705,1487,86.8099975586,67.9400024414,32.0600013733
170318048052,157,303,460,46.8899993896,80.6800003052,19.3199996948
170318048053,310,935,1245,86.3399963379,90.7799987793,9.22000026703
170318048054,1204,1058,2262,80.6100006104,59.5600013733,40.4399986267
170318048061,126,0,126,14.1899995804,0.0,100.0
170318048062,123,341,464,39.6899986267,81.0800018311,18.9200000763
170318048063,655,103,758,43.8899993896,8.97000026703,91.0299987793
170318048071,116,426,542,57.6599998474,88.9199981689,11.0799999237
170318048072,71,384,455,52.8499984741,88.0299987793,11.970000267
170318048073,854,174,1028,48.7700004578,30.1700000763,69.8300018311
170318048074,326,449,775,63.1599998474,72.9199981689,27.0799999237
170318048081,193,295,488,70.2200012207,67.2300033569,32.7700004578
170318048082,301,699,1000,94.5199966431,76.4700012207,23.5300006866
170318048083,116,339,455,56.4500007629,91.3199996948,8.68000030518
170318048091,328,706,1034,76.7099990845,85.5699996948,14.4300003052
170318048092,863,440,1303,75.6200027466,54.9700012207,45.0299987793
170318048093,296,358,654,56.6699981689,74.0800018311,25.9200000763
170318048101,414,459,873,66.2399978638,50.7799987793,49.2200012207
170318048102,318,333,651,58.5400009155,54.5200004578,45.4799995422
170318048103,1711,535,2246,83.9300003052,42.4199981689,57.5800018311
170318048104,854,368,1222,67.5899963379,39.6100006104,60.3899993896
170318049011,1027,330,1357,87.7699966431,34.4300003052,65.5699996948
170318049012,650,197,847,91.5699996948,32.5400009155,67.4599990845
170318049013,630,143,773,57.0099983215,14.3699998856,85.6299972534
170318049014,316,103,419,54.3499984741,0.0,0.0
170318049015,715,184,899,76.0599975586,30.9099998474,69.0899963379
170318049016,367,308,675,79.7900009155,58.6699981689,41.3300018311
170318049021,641,531,1172,84.9300003052,53.4500007629,46.5499992371
170318049022,507,516,1023,84.7600021362,58.9399986267,41.0600013733
170318049023,224,247,471,51.3100013733,75.6999969482,24.2999992371
170318049024,260,447,707,54.8499984741,72.5299987793,27.4699993134
170318049025,316,310,626,85.8700027466,59.0699996948,40.9300003052
170318050011,213,276,489,51.7999992371,90.5,9.5
170318050012,186,356,542,50.4199981689,76.4400024414,23.5599994659
170318050013,520,314,834,49.8499984741,52.2799987793,47.7200012207
170318050014,218,486,704,67.3700027466,80.2200012207,19.7800006866
170318050021,417,341,758,41.5099983215,50.5900001526,49.4099998474
170318050022,440,684,1124,62.7599983215,20.6299991608,79.3700027466
170318050023,610,432,1042,77.9400024414,62.0,38.0
170318050024,636,60,696,77.5899963379,28.4699993134,71.5299987793
170318050025,198,790,988,92.6800003052,81.7200012207,18.2800006866
170318051051,1163,1371,2534,84.0699996948,62.2700004578,37.7299995422
170318051052,519,334,853,73.5299987793,30.3199996948,69.6800003052
170318051053,1404,191,1595,96.6100006104,34.3899993896,65.6100006104
170318051054,1095,410,1505,100.0,33.0999984741,66.9000015259
170318051061,571,467,1038,98.3899993896,62.9300003052,37.0699996948
170318051062,392,416,808,48.8199996948,65.2200012207,34.7799987793
170318051071,505,168,673,42.25,20.7700004578,79.2300033569
170318051072,414,361,775,68.5199966431,33.4799995422,66.5199966431
170318051073,469,388,857,95.0100021362,43.6800003052,56.3199996948
170318051074,1434,612,2046,95.1600036621,31.5400009155,68.4599990845
170318051075,540,114,654,91.7300033569,24.2299995422,75.7699966431
170318051081,1582,832,2414,86.7699966431,45.5900001526,54.4099998474
170318051082,1034,363,1397,65.4599990845,34.4900016785,65.5100021362
170318051083,240,491,731,79.8000030518,69.6100006104,30.3899993896
170318051084,174,427,601,66.9300003052,78.7300033569,21.2700004578
170318051091,225,434,659,53.2700004578,62.0400009155,37.9599990845
170318051092,537,479,1016,52.2400016785,45.2099990845,54.7900009155
170318051093,388,242,630,54.0299987793,49.5800018311,50.4199981689
170318051101,219,951,1170,65.2900009155,83.8399963379,16.1599998474
170318051102,100,332,432,40.0699996948,76.8700027466,23.1299991608
170318051103,548,44,592,92.6399993896,27.8400001526,72.1600036621
170318051104,121,133,254,36.7599983215,67.3199996948,32.6800003052
170318051111,311,263,574,82.5899963379,58.7200012207,41.2799987793
170318051112,264,306,570,68.5899963379,51.0,49.0
170318051113,1910,314,2224,92.4000015259,28.0400009155,71.9599990845
170318051114,1179,55,1234,92.3700027466,28.7399997711,71.2600021362
170318051115,620,101,721,98.7699966431,18.8400001526,81.1600036621
170318051116,548,315,863,82.7399978638,19.7700004578,80.2300033569
170318051121,1168,554,1722,94.0999984741,23.7800006866,76.2200012207
170318051122,866,498,1364,79.8600006104,51.6599998474,48.3400001526
170318052011,380,446,826,89.1999969482,73.3899993896,26.6100006104
170318052012,451,288,739,88.5,61.6300010681,38.3699989319
170318052013,661,229,890,54.5999984741,32.0400009155,67.9599990845
170318052021,219,579,798,89.9700012207,88.6699981689,11.3299999237
170318052022,302,308,610,89.9700012207,71.9599990845,28.0400009155
170318052023,510,615,1125,90.6500015259,65.4199981689,34.5800018311
170318052024,730,246,976,80.5899963379,39.7000007629,60.2999992371
170318053011,456,235,691,82.3600006104,25.9599990845,74.0400009155
170318053012,612,420,1032,64.5,53.0499992371,46.9500007629
170318053013,1018,22,1040,100.0,18.5599994659,81.4400024414
170318053021,566,315,881,99.6600036621,53.75,46.25
170318053022,500,229,729,55.6899986267,52.4399986267,47.5600013733
170318053023,900,446,1346,96.2099990845,60.4500007629,39.5499992371
170318054011,972,141,1113,91.6800003052,30.8700008392,69.1299972534
170318054012,846,473,1319,89.2399978638,50.4000015259,49.5999984741
170318054013,486,54,540,46.0400009155,29.0200004578,70.9800033569
170318054021,691,50,741,79.0,11.7399997711,88.2600021362
170318054022,408,366,774,81.8199996948,62.1899986267,37.8100013733
170318054023,619,228,847,93.3799972534,51.6300010681,48.3699989319
170318054024,1262,132,1394,90.4000015259,31.5499992371,68.4499969482
170318054025,634,116,750,96.0299987793,21.5400009155,78.4599990845
170318055011,709,182,891,98.2399978638,40.6599998474,59.3400001526
170318055012,1098,132,1230,92.5500030518,41.2099990845,58.7900009155
170318055013,888,211,1099,93.5299987793,48.75,51.25
170318055021,124,617,741,70.3000030518,93.4700012207,6.53000020981
170318055022,229,491,720,81.2600021362,80.1500015259,19.8500003815
170318055023,347,481,828,83.7200012207,65.8399963379,34.1599998474
170318055024,469,455,924,95.6500015259,64.0599975586,35.9399986267
170318056001,733,662,1395,96.9400024414,74.0999984741,25.8999996185
170318056002,575,628,1203,92.9700012207,73.3099975586,26.6900005341
170318056003,303,347,650,69.5199966431,60.6399993896,39.3600006104
170318056004,499,255,754,87.9800033569,57.6800003052,42.3199996948
170318057011,621,493,1114,94.8899993896,81.0800018311,18.9200000763
170318057012,394,214,608,91.4300003052,69.8799972534,30.1200008392
170318057013,496,609,1105,88.2600021362,82.7300033569,17.2700004578
170318057014,408,440,848,90.5,89.8600006104,10.1400003433
170318057015,332,550,882,83.0500030518,47.9199981689,52.0800018311
170318057021,483,321,804,67.4499969482,50.3699989319,49.6300010681
170318057022,569,175,744,87.0199966431,88.2799987793,11.720000267
170318058011,356,305,661,80.5100021362,53.0800018311,46.9199981689
170318058012,220,502,722,82.1399993896,75.7099990845,24.2900009155
170318058013,204,475,679,91.8799972534,83.1699981689,16.8299999237
170318058021,761,128,889,93.9700012207,44.3400001526,55.6599998474
170318058022,264,175,439,50.1100006104,63.9900016785,36.0099983215
170318058023,884,187,1071,94.8600006104,44.7900009155,55.2099990845
170318058024,661,316,977,97.8000030518,58.4199981689,41.5800018311
170318058025,322,418,740,77.9800033569,78.3600006104,21.6399993896
170318059011,1167,166,1333,89.1600036621,41.2599983215,58.7400016785
170318059012,966,129,1095,92.4100036621,49.1800003052,50.8199996948
170318059013,1008,66,1074,92.5100021362,56.0499992371,43.9500007629
170318059021,462,245,707,81.0800018311,48.2400016785,51.7599983215
170318059022,896,181,1077,82.1500015259,22.9599990845,77.0400009155
170318059023,205,152,357,34.7599983215,52.75,47.25
170318059024,705,246,951,86.9300003052,51.0299987793,48.9700012207
170318059025,65,24,89,10.2700004578,0.0,0.0
170318059026,778,264,1042,81.7900009155,36.0,64.0
170318060011,618,457,1075,95.3899993896,51.2700004578,48.7299995422
170318060012,895,450,1345,64.0500030518,15.6800003052,84.3199996948
170318060013,989,397,1386,75.1600036621,22.9599990845,77.0400009155
170318060014,325,117,442,61.2200012207,44.6599998474,55.3400001526
170318060021,580,391,971,91.1699981689,47.0999984741,52.9000015259
170318060022,1782,99,1881,73.8799972534,56.2900009155,43.7099990845
170318060023,1009,194,1203,87.9400024414,22.2800006866,77.7200012207
170318060024,484,228,712,61.1199989319,23.3500003815,76.6500015259
170318060025,1271,100,1371,92.9499969482,19.6200008392,80.3799972534
170318060031,908,304,1212,90.7200012207,29.4400005341,70.5599975586
170318060032,386,290,676,69.5500030518,44.2700004578,55.7299995422
170318060033,0,0,0,0.0,0.0,0.0
170318060034,0,0,0,0.0,0.0,0.0
170318060035,0,0,0,0.0,0.0,0.0
170318060036,822,175,997,68.6200027466,32.9199981689,67.0800018311
170318060041,1573,295,1868,94.4400024414,18.3400001526,81.6600036621
170318060042,1706,560,2266,76.6299972534,17.0699996948,82.9300003052
170318060043,628,462,1090,66.0199966431,35.1599998474,64.8399963379
170318060044,951,32,983,94.3399963379,14.9200000763,85.0800018311
170318061021,1127,355,1482,84.1100006104,38.5900001526,61.4099998474
170318061022,452,482,934,83.0999984741,56.4799995422,43.5200004578
170318061023,571,425,996,91.5400009155,62.1199989319,37.8800010681
170318061031,857,610,1467,90.3899993896,56.8400001526,43.1599998474
170318061032,680,208,888,96.4199981689,40.4700012207,59.5299987793
170318061033,715,365,1080,84.4400024414,65.5299987793,34.4700012207
170318061034,623,496,1119,80.6800003052,42.4799995422,57.5200004578
170318061041,1574,18,1592,100.0,9.06999969482,90.9300003052
170318061042,740,61,801,88.3099975586,47.0800018311,52.9199981689
170318061043,393,376,769,43.6199989319,80.25,19.75
170318062011,1886,140,2026,91.3399963379,15.3599996567,84.6399993896
170318062012,1918,15,1933,96.5500030518,16.8099994659,83.1900024414
170318062021,430,68,498,67.3899993896,20.8299999237,79.1699981689
170318062022,1208,582,1790,99.9400024414,49.9799995422,50.0200004578
170318062023,1863,98,1961,96.7900009155,37.2700004578,62.7299995422
170318063001,209,158,367,38.1100006104,95.0899963379,4.90999984741
170318063002,190,393,583,69.1600036621,61.7299995422,38.2700004578
170318063003,463,218,681,90.4400024414,42.4199981689,57.5800018311
170318063004,173,497,670,90.0500030518,84.4700012207,15.529999733
170318063005,269,408,677,77.6399993896,74.8000030518,25.2000007629
170318063006,310,362,672,88.6500015259,74.5299987793,25.4699993134
170318064001,802,463,1265,90.6800003052,59.6899986267,40.3100013733
170318064002,583,322,905,83.9499969482,55.4199981689,44.5800018311
170318065011,974,242,1216,94.4100036621,55.0900001526,44.9099998474
170318065012,1283,186,1469,100.0,28.4200000763,71.5800018311
170318065021,711,25,736,83.1600036621,24.0300006866,75.9700012207
170318065022,121,189,310,40.2099990845,77.9000015259,22.1000003815
170318065023,582,272,854,76.1100006104,40.8899993896,59.1100006104
170318065024,819,0,819,57.9599990845,18.0900001526,81.9100036621
170318066001,810,389,1199,63.9099998474,33.3300018311,66.6699981689
170318066002,1111,37,1148,71.0800018311,27.2099990845,72.7900009155
170318067001,720,548,1268,90.3799972534,63.5800018311,36.4199981689
170318067002,426,556,982,82.2399978638,74.1600036621,25.8400001526
170318067003,688,253,941,89.9599990845,56.7200012207,43.2799987793
170318067004,512,214,726,95.7799987793,45.5299987793,54.4700012207
170318068011,597,136,733,95.1900024414,71.0,29.0
170318068012,1346,235,1581,96.1100006104,50.3199996948,49.6800003052
170318068013,489,348,837,73.2300033569,51.6599998474,48.3400001526
170318068014,602,86,688,95.8199996948,48.3600006104,51.6399993896
170318068021,490,91,581,71.7300033569,18.2399997711,81.7600021362
170318068022,1268,246,1514,99.6699981689,50.5299987793,49.4700012207
170318068023,657,207,864,94.4300003052,33.4500007629,66.5500030518
170318069001,664,183,847,92.4700012207,35.7900009155,64.2099990845
170318069002,1633,117,1750,86.5899963379,17.3999996185,82.5999984741
170318069003,1055,582,1637,92.0199966431,67.8399963379,32.1599998474
170318070001,2535,180,2715,95.9000015259,28.3199996948,71.6800003052
170318070002,1058,6,1064,93.7399978638,6.48999977112,93.5100021362
170318070003,539,435,974,90.0199966431,79.0400009155,20.9599990845
170318070004,669,17,686,95.1500015259,28.7700004578,71.2300033569
170318071001,551,167,718,91.6999969482,40.3800010681,59.6199989319
170318071002,1086,285,1371,91.2799987793,47.9700012207,52.0299987793
170318071003,921,301,1222,80.8199996948,48.5499992371,51.4500007629
170318072001,634,220,854,87.5,63.3300018311,36.6699981689
170318072002,1318,532,1850,85.0999984741,37.7700004578,62.2299995422
170318072003,555,300,855,82.6100006104,40.2799987793,59.7200012207
170318072004,427,294,721,83.6399993896,57.2900009155,42.7099990845
170318072005,653,93,746,85.9400024414,29.8500003815,70.1500015259
170318073001,2439,152,2591,98.8899993896,32.1599998474,67.8399963379
170318073002,1160,170,1330,93.4000015259,18.2000007629,81.8000030518
170318073003,1341,74,1415,99.3000030518,35.8400001526,64.1600036621
170318073004,587,230,817,90.8799972534,46.9199981689,53.0800018311
170318073005,593,186,779,96.0500030518,53.8899993896,46.1100006104
170318074001,380,97,477,62.1899986267,21.1299991608,78.8700027466
170318074002,836,348,1184,79.8399963379,42.0600013733,57.9399986267
170318074003,2351,14,2365,94.7099990845,12.8699998856,87.1299972534
170318074004,382,61,443,64.8600006104,13.279999733,86.7200012207
170318074005,770,250,1020,91.4800033569,37.5499992371,62.4500007629
170318075001,863,137,1000,91.5800018311,25.3299999237,74.6699981689
170318075002,706,77,783,86.6200027466,24.8600006104,75.1399993896
170318075003,959,135,1094,91.3199996948,22.4799995422,77.5199966431
170318076001,928,175,1103,84.7799987793,40.2799987793,59.7200012207
170318076002,977,400,1377,88.4400024414,38.9799995422,61.0200004578
170318076003,723,33,756,89.7900009155,38.5400009155,61.4599990845
170318076004,1158,138,1296,96.2900009155,33.0900001526,66.9100036621
170318076005,723,451,1174,79.1100006104,44.3600006104,55.6399993896
170318077001,1747,194,1941,98.5299987793,42.2700004578,57.7299995422
170318077002,1192,273,1465,95.9400024414,43.8199996948,56.1800003052
170318077003,944,154,1098,98.7399978638,47.4000015259,52.5999984741
170318077004,728,531,1259,96.4000015259,61.0699996948,38.9300003052
170318078001,552,240,792,60.5999984741,32.4399986267,67.5599975586
170318078002,797,333,1130,84.7099990845,42.9900016785,57.0099983215
170318079001,910,226,1136,78.6699981689,48.3100013733,51.6899986267
170318079002,711,189,900,71.0899963379,60.6699981689,39.3300018311
170318079003,460,460,920,66.8099975586,74.6399993896,25.3600006104
170318080011,814,213,1027,83.2900009155,30.1100006104,69.8899993896
170318080012,1008,68,1076,96.3300018311,24.7900009155,75.2099990845
170318080013,513,274,787,60.6800003052,80.6200027466,19.3799991608
170318080021,816,176,992,84.5699996948,36.0299987793,63.9700012207
170318080022,624,82,706,50.8300018311,13.5399999619,86.4599990845
170318080023,991,120,1111,74.6600036621,15.5100002289,84.4899978638
170318080024,697,44,741,93.2099990845,19.7600002289,80.2399978638
170318081001,1403,254,1657,93.25,32.0,68.0
170318081002,1628,255,1883,87.0999984741,27.7000007629,72.3000030518
170318082001,1735,367,2102,97.1299972534,54.6500015259,45.3499984741
170318082002,1191,93,1284,97.4199981689,31.3500003815,68.6500015259
170318082003,1056,230,1286,76.5,28.5200004578,71.4800033569
170318083011,636,104,740,89.6999969482,44.6899986267,55.3100013733
170318083012,2108,70,2178,89.2600021362,21.4099998474,78.5899963379
170318083013,956,202,1158,97.1500015259,20.8799991608,79.1200027466
170318083014,547,197,744,64.1900024414,22.6000003815,77.4000015259
170318083021,800,565,1365,100.0,67.6399993896,32.3600006104
170318083022,1468,356,1824,97.4400024414,48.6699981689,51.3300018311
170318083023,527,139,666,94.7399978638,50.2400016785,49.7599983215
170318084001,1288,523,1811,96.5400009155,52.7900009155,47.2099990845
170318084002,642,119,761,90.1699981689,40.9900016785,59.0099983215
170318084003,1457,176,1633,98.3099975586,44.75,55.25
170318085001,599,447,1046,78.3499984741,75.5400009155,24.4599990845
170318085002,707,212,919,100.0,53.0600013733,46.9399986267
170318085003,476,269,745,82.4100036621,36.5999984741,63.4000015259
170318085004,419,150,569,60.0200004578,31.0900001526,68.9100036621
170318086001,200,371,571,48.0999984741,89.5899963379,10.4099998474
170318086002,232,459,691,83.7600021362,74.4800033569,25.5200004578
170318087021,2299,602,2901,100.0,57.9000015259,42.0999984741
170318087022,1201,1248,2449,98.4700012207,79.5100021362,20.4899997711
170318088001,1007,471,1478,85.0899963379,41.9300003052,58.0699996948
170318088002,824,1123,1947,87.3499984741,84.2099990845,15.7899999619
170318089001,653,451,1104,80.8199996948,44.6599998474,55.3400001526
170318089002,226,198,424,56.9099998474,50.5400009155,49.4599990845
170318089003,807,838,1645,81.9599990845,70.0699996948,29.9300003052
170318090001,161,357,518,75.2900009155,89.6900024414,10.3100004196
170318090002,210,248,458,53.0099983215,37.8199996948,62.1800003052
170318090003,330,684,1014,70.4700012207,75.1999969482,24.7999992371
170318090004,204,579,783,80.4700012207,84.0400009155,15.9600000381
170318091001,711,316,1027,88.6100006104,41.6199989319,58.3800010681
170318091002,246,428,674,75.4800033569,79.5999984741,20.3999996185
170318091003,192,468,660,50.3800010681,88.0599975586,11.9399995804
170318092001,634,386,1020,94.0999984741,33.4199981689,66.5800018311
170318092002,1018,238,1256,99.3700027466,27.3899993896,72.6100006104
170318092003,1077,194,1271,100.0,46.0800018311,53.9199981689
170318092004,664,310,974,96.7200012207,66.9199981689,33.0800018311
170318093001,190,720,910,92.9499969482,76.0299987793,23.9699993134
170318093002,648,1000,1648,83.4000015259,73.1900024414,26.8099994659
170318093003,1269,542,1811,93.3499984741,43.2200012207,56.7799987793
170318094001,499,412,911,100.0,89.0899963379,10.9099998474
170318094002,1353,193,1546,99.0400009155,33.4500007629,66.5500030518
170318094003,1881,117,1998,98.3300018311,10.7700004578,89.2300033569
170318094004,1181,165,1346,98.75,38.6699981689,61.3300018311
170318095001,1199,129,1328,93.3199996948,39.2200012207,60.7799987793
170318095002,1188,142,1330,98.7399978638,61.8100013733,38.1899986267
170318095003,623,251,874,98.7600021362,65.5899963379,34.4099998474
170318096001,225,438,663,82.9800033569,81.3600006104,18.6399993896
170318096002,981,281,1262,97.9800033569,51.6800003052,48.3199996948
170318096003,600,425,1025,83.6100006104,44.0600013733,55.9399986267
170318097001,279,670,949,78.5599975586,80.7799987793,19.2199993134
170318097002,934,615,1549,93.4800033569,45.4900016785,54.5099983215
170318097003,416,218,634,80.7600021362,50.7299995422,49.2700004578
170318098001,343,611,954,94.9300003052,82.3600006104,17.6399993896
170318098002,1484,243,1727,99.3099975586,52.2700004578,47.7299995422
170318099001,1886,954,2840,100.0,52.25,47.75
170318100001,1184,498,1682,99.4100036621,46.2099990845,53.7900009155
170318100002,1390,339,1729,98.0199966431,40.3300018311,59.6699981689
170318100003,961,491,1452,99.0500030518,70.5800018311,29.4200000763
170318101001,489,41,530,100.0,13.3100004196,86.6900024414
170318101002,477,679,1156,100.0,54.0299987793,45.9700012207
170318101003,661,207,868,100.0,74.0199966431,25.9799995422
170318101004,332,246,578,99.1399993896,73.7799987793,26.2199993134
170318101005,836,204,1040,94.8000030518,58.3899993896,41.6100006104
170318102001,428,528,956,100.0,65.0899963379,34.9099998474
170318102002,1036,6,1042,99.4300003052,9.27999973297,90.7200012207
170318102003,870,0,870,97.8600006104,19.3099994659,80.6900024414
170318102004,674,590,1264,95.1800003052,55.4599990845,44.5400009155
170318102005,447,170,617,91.8199996948,67.3600006104,32.6399993896
170318102006,691,128,819,90.8000030518,35.8899993896,64.1100006104
170318103011,275,284,559,75.4400024414,45.9399986267,54.0600013733
170318103012,378,505,883,93.8399963379,54.5499992371,45.4500007629
170318103013,965,316,1281,96.9000015259,52.1100006104,47.8899993896
170318103014,829,175,1004,93.7399978638,45.6699981689,54.3300018311
170318103021,625,620,1245,92.9800033569,71.6699981689,28.3299999237
170318103022,371,537,908,82.9199981689,78.9899978638,21.0100002289
170318103023,572,259,831,100.0,57.6199989319,42.3800010681
170318104001,566,207,773,93.3600006104,50.0499992371,49.9500007629
170318104002,487,283,770,62.2000007629,58.1500015259,41.8499984741
170318104003,1662,230,1892,81.4100036621,27.2099990845,72.7900009155
170318104004,585,150,735,75.6999969482,28.3899993896,71.6100006104
170318105011,778,239,1017,89.2900009155,33.0600013733,66.9400024414
170318105012,865,66,931,86.6900024414,36.0499992371,63.9500007629
170318105013,795,132,927,99.3600006104,36.3499984741,63.6500015259
170318105014,555,164,719,77.9800033569,28.3799991608,71.6200027466
170318105015,451,173,624,62.1500015259,34.3300018311,65.6699981689
170318105021,836,41,877,91.5400009155,3.97000002861,96.0299987793
170318105022,638,92,730,97.3300018311,9.34000015259,90.6600036621
170318105023,1408,155,1563,93.2600021362,10.8199996948,89.1800003052
170318105024,702,11,713,80.6600036621,0.0,100.0
170318105025,622,14,636,69.2799987793,5.42999982834,94.5699996948
170318106001,998,40,1038,74.6800003052,52.7000007629,47.2999992371
170318106002,1462,196,1658,97.8199996948,29.4200000763,70.5800018311
170318106003,1271,146,1417,90.1999969482,16.3700008392,83.6299972534
170318107011,563,11,574,43.9799995422,2.0,98.0
170318107012,422,0,422,31.8999996185,0.0,100.0
170318107013,327,0,327,30.1100006104,0.0,100.0
170318107014,813,0,813,66.75,0.0,100.0
170318107021,1437,0,1437,100.0,0.0,100.0
170318107022,786,0,786,100.0,16.3799991608,83.6200027466
170318107023,1575,63,1638,96.3499984741,19.6299991608,80.3700027466
170318108001,920,0,920,95.7300033569,0.0,100.0
170318108002,1157,194,1351,80.0400009155,17.2000007629,82.8000030518
170318108003,0,0,0,0.0,0.0,0.0
170318108004,102,0,102,8.22999954224,0.0,0.0
170318109001,1761,28,1789,92.2200012207,11.5699996948,88.4300003052
170318109002,842,109,951,66.3199996948,10.5600004196,89.4400024414
170318109003,475,0,475,63.6699981689,0.0,100.0
170318109004,823,0,823,91.9599990845,2.48000001907,97.5199966431
170318109005,716,17,733,51.7999992371,7.42999982834,92.5699996948
170318110001,493,64,557,78.4499969482,16.6000003815,83.4000015259
170318110002,0,0,0,0.0,0.0,0.0
170318110003,0,0,0,0.0,0.0,0.0
170318110004,518,76,594,71.5699996948,14.5,85.5
170318110005,471,63,534,47.8100013733,59.0,41.0
170318111001,433,0,433,95.3700027466,5.73999977112,94.2600021362
170318111002,1577,187,1764,98.8799972534,24.5699996948,75.4300003052
170318111003,683,111,794,92.5400009155,64.5599975586,35.4399986267
170318111004,934,23,957,90.6200027466,23.1499996185,76.8499984741
170318111005,1561,104,1665,69.5500030518,24.4200000763,75.5800018311
170318112001,783,34,817,86.6399993896,34.2700004578,65.7300033569
170318112002,989,144,1133,75.2300033569,18.0599994659,81.9400024414
170318112003,133,228,361,37.7200012207,66.7900009155,33.2099990845
170318112004,288,85,373,31.8299999237,21.4500007629,78.5500030518
170318112005,288,374,662,96.2200012207,42.9599990845,57.0400009155
170318113011,879,114,993,77.6999969482,20.3899993896,79.6100006104
170318113012,173,0,173,20.6900005341,0.0,100.0
170318113013,1001,178,1179,87.7900009155,25.9400005341,74.0599975586
170318113014,286,67,353,25.7700004578,12.3699998856,87.6299972534
170318113021,676,179,855,66.3300018311,39.4099998474,60.5900001526
170318113022,900,15,915,37.1500015259,8.68999958038,91.3099975586
170318114011,706,0,706,80.9599990845,0.0,100.0
170318114012,420,24,444,45.4900016785,0.0,0.0
170318114013,601,76,677,66.6999969482,0.0,100.0
170318114014,838,73,911,93.8199996948,15.529999733,84.4700012207
170318114015,856,89,945,96.4300003052,23.9400005341,76.0599975586
170318114021,824,365,1189,90.4899978638,27.7000007629,72.3000030518
170318114022,1215,48,1263,81.5400009155,9.63000011444,90.3700027466
170318114023,746,383,1129,71.0500030518,48.9099998474,51.0900001526
170318115001,1228,316,1544,93.1200027466,41.4700012207,58.5299987793
170318115002,252,187,439,27.1700000763,46.6699981689,53.3300018311
170318115003,996,114,1110,93.5899963379,11.3299999237,88.6699981689
170318115004,693,0,693,48.0200004578,4.48000001907,95.5199966431
170318116001,1628,2,1630,96.0500030518,50.8499984741,49.1500015259
170318116002,1047,40,1087,73.25,13.1700000763,86.8300018311
170318116003,912,178,1090,72.1900024414,21.1499996185,78.8499984741
170318116004,608,335,943,61.7099990845,45.1899986267,54.8100013733
170318117011,1260,634,1894,80.5299987793,11.3500003815,88.6500015259
170318117012,1128,68,1196,77.4599990845,22.2700004578,77.7300033569
170318117021,0,0,0,0.0,1.0,99.0
170318117022,1104,442,1546,85.4599990845,51.9700012207,48.0299987793
170318117023,743,643,1386,66.8000030518,46.0699996948,53.9300003052
170318118001,136,158,294,30.2800006866,59.4300003052,40.5699996948
170318118002,810,253,1063,75.2799987793,10.6499996185,89.3499984741
170318118003,653,502,1155,73.9899978638,56.2200012207,43.7799987793
170318118004,852,28,880,59.4199981689,4.38000011444,95.6200027466
170318119001,579,278,857,82.9599990845,49.1300010681,50.8699989319
170318119002,610,608,1218,79.5,80.7799987793,19.2199993134
170318119003,188,912,1100,85.9400024414,95.8300018311,4.17000007629
170318119004,696,981,1677,85.4300003052,82.8300018311,17.1700000763
170318120001,301,367,668,91.2600021362,78.3199996948,21.6800003052
170318120002,419,330,749,98.8099975586,51.5800018311,48.4199981689
170318120003,571,861,1432,99.7900009155,86.4700012207,13.529999733
170318120004,173,464,637,98.3000030518,95.5400009155,4.46000003815
170318120005,303,523,826,73.6800003052,92.3600006104,7.63999986649
170318120006,216,572,788,95.75,91.3399963379,8.65999984741
170318121001,682,234,916,96.9300003052,36.3400001526,63.6599998474
170318121002,803,134,937,95.1299972534,52.1300010681,47.8699989319
170318121003,391,458,849,83.2399978638,88.4700012207,11.529999733
170318121004,566,336,902,100.0,68.6900024414,31.3099994659
170318121005,438,311,749,93.6200027466,55.7000007629,44.2999992371
170318122001,726,204,930,91.9000015259,33.0699996948,66.9300003052
170318122002,250,500,750,86.7099990845,83.5500030518,16.4500007629
170318122003,516,525,1041,91.5599975586,75.0500030518,24.9500007629
170318122004,683,181,864,93.5100021362,40.9599990845,59.0400009155
170318123011,464,214,678,93.9100036621,11.9799995422,88.0199966431
170318123012,1360,368,1728,97.6800003052,17.5,82.5
170318123013,1213,294,1507,100.0,49.2799987793,50.7200012207
170318123021,455,372,827,87.6999969482,59.9000015259,40.0999984741
170318123022,503,420,923,88.3300018311,53.0699996948,46.9300003052
170318123023,624,187,811,100.0,45.8899993896,54.1100006104
170318124001,386,842,1228,94.9700012207,82.6200027466,17.3799991608
170318124002,456,666,1122,99.1999969482,89.8799972534,10.1199998856
170318124003,335,701,1036,96.5500030518,87.7099990845,12.2899999619
170318125001,767,185,952,96.3600006104,46.7200012207,53.2799987793
170318125002,677,101,778,94.1900024414,39.8300018311,60.1699981689
170318125003,490,289,779,95.1200027466,57.2099990845,42.7900009155
170318125004,454,336,790,98.6299972534,68.0299987793,31.9699993134
170318126001,383,296,679,90.4100036621,76.9100036621,23.0900001526
170318126002,706,451,1157,96.8199996948,68.8099975586,31.1900005341
170318126003,752,320,1072,100.0,50.5299987793,49.4700012207
170318126004,429,277,706,96.7099990845,80.9199981689,19.0799999237
170318127001,566,421,987,98.3099975586,78.3199996948,21.6800003052
170318127002,404,508,912,89.0599975586,71.2399978638,28.7600002289
170318127003,1003,193,1196,100.0,48.5,51.5
170318128011,1252,533,1785,100.0,65.8700027466,34.1300010681
170318128012,854,214,1068,82.7900009155,42.6199989319,57.3800010681
170318128021,196,325,521,73.6900024414,75.0999984741,24.8999996185
170318128022,456,227,683,89.2799987793,43.4500007629,56.5499992371
170318128023,619,360,979,98.3899993896,64.5699996948,35.4300003052
170318129001,249,393,642,67.5100021362,0.0,0.0
170318129002,728,212,940,89.5199966431,39.0400009155,60.9599990845
170318129003,926,324,1250,94.7699966431,47.5699996948,52.4300003052
170318129004,705,452,1157,80.0100021362,44.0900001526,55.9099998474
170318130001,211,362,573,81.8600006104,75.8399963379,24.1599998474
170318130002,490,336,826,86.4899978638,49.1899986267,50.8100013733
170318130003,264,308,572,85.8899993896,60.0400009155,39.9599990845
170318130004,307,402,709,81.4000015259,63.8100013733,36.1899986267
170318130005,419,279,698,98.4499969482,56.0099983215,43.9900016785
170318131001,770,46,816,97.0299987793,20.9300003052,79.0699996948
170318131002,964,15,979,94.8600006104,28.5499992371,71.4499969482
170318131003,625,80,705,92.7600021362,38.4399986267,61.5600013733
170318131004,567,60,627,98.7399978638,32.2999992371,67.6999969482
170318131005,1145,80,1225,94.6699981689,34.3400001526,65.6600036621
170318132001,673,91,764,98.7099990845,32.5400009155,67.4599990845
170318132002,575,144,719,97.0299987793,40.6100006104,59.3899993896
170318132003,617,85,702,91.8799972534,28.1499996185,71.8499984741
170318132004,692,147,839,87.8499984741,50.1899986267,49.8100013733
170318132005,581,291,872,83.0500030518,22.2900009155,77.7099990845
170318133011,1518,139,1657,92.4100036621,4.90000009537,95.0999984741
170318133012,440,40,480,63.2400016785,0.0,0.0
170318133013,901,0,901,90.4599990845,0.0,100.0
170318133021,1253,50,1303,78.6399993896,1.98000001907,98.0199966431
170318133022,2101,1,2102,94.3399963379,2.88000011444,97.1200027466
170318134001,1258,137,1395,100.0,4.34999990463,95.6500015259
170318134002,1062,90,1152,100.0,5.42999982834,94.5699996948
170318134003,268,56,324,31.7000007629,23.7900009155,76.2099990845
170318134004,392,642,1034,69.8600006104,0.0,0.0
170318134005,555,50,605,42.9700012207,0.0,0.0
170318134006,951,156,1107,100.0,11.0500001907,88.9499969482
170318135001,1364,242,1606,100.0,40.6500015259,59.3499984741
170318135002,794,509,1303,98.1900024414,55.5,44.5
170318135003,785,161,946,87.1100006104,0.0,100.0
170318135004,531,520,1051,68.5100021362,0.0,0.0
170318135005,1001,160,1161,79.3000030518,0.0,100.0
170318136001,1253,124,1377,100.0,11.6499996185,88.3499984741
170318136002,1756,85,1841,82.3700027466,12.5500001907,87.4499969482
170318136003,1390,253,1643,94.6999969482,12.1899995804,87.8099975586
170318137011,1483,0,1483,67.4400024414,1.32000005245,98.6800003052
170318137012,1525,0,1525,94.1399993896,11.6599998474,88.3399963379
170318137021,988,0,988,86.3600006104,0.0,100.0
170318137022,617,0,617,100.0,0.0,100.0
170318137023,1051,0,1051,78.9599990845,0.0,100.0
170318137024,783,0,783,67.2099990845,0.0,100.0
170318138011,659,0,659,80.8600006104,0.0,100.0
170318138012,916,0,916,100.0,0.0,100.0
170318138013,1165,0,1165,100.0,7.71999979019,92.2799987793
170318138021,1058,0,1058,97.5100021362,5.59000015259,94.4100036621
170318138022,1233,34,1267,100.0,11.9099998474,88.0899963379
170318138023,934,93,1027,81.9000015259,18.6299991608,81.3700027466
170318138024,1420,0,1420,92.9300003052,22.6100006104,77.3899993896
170318139001,1350,193,1543,92.9499969482,8.82999992371,91.1699981689
170318139002,1248,81,1329,100.0,6.40999984741,93.5899963379
170318139003,1060,0,1060,100.0,2.63000011444,97.3700027466
170318139004,817,16,833,76.8499984741,10.2700004578,89.7300033569
170318139005,994,55,1049,89.5100021362,14.2600002289,85.7399978638
170318140001,1080,29,1109,87.8799972534,14.6800003052,85.3199996948
170318140002,1168,55,1223,94.0,21.6700000763,78.3300018311
170318140003,1148,0,1148,97.2900009155,15.6999998093,84.3000030518
170318140004,959,0,959,94.9499969482,19.7199993134,80.2799987793
170318141001,2037,82,2119,94.0500030518,8.85999965668,91.1399993896
170318141002,1100,59,1159,86.4899978638,10.8400001526,89.1600036621
170318141003,860,50,910,100.0,4.51999998093,95.4800033569
170318142001,1320,88,1408,100.0,1.62999999523,98.3700027466
170318142002,681,0,681,97.9899978638,1.13999998569,98.8600006104
170318142003,462,158,620,52.6300010681,33.5499992371,66.4499969482
170318142004,1016,48,1064,63.9799995422,4.07000017166,95.9300003052
170318142005,963,11,974,74.2900009155,6.88000011444,93.1200027466
170318142006,1081,13,1094,96.4700012207,5.71000003815,94.2900009155
170318143001,1822,51,1873,85.6399993896,26.5300006866,73.4700012207
170318143002,1741,228,1969,72.2799987793,18.8199996948,81.1800003052
170318144001,762,116,878,80.2600021362,15.4799995422,84.5199966431
170318144002,755,112,867,73.7200012207,12.0600004196,87.9400024414
170318144003,930,336,1266,93.2900009155,36.6300010681,63.3699989319
170318144004,354,517,871,65.3399963379,60.2900009155,39.7099990845
170318144005,654,230,884,50.8300018311,35.7900009155,64.2099990845
170318144006,375,194,569,64.1500015259,9.15999984741,90.8399963379
170318145001,1260,100,1360,64.6100006104,6.38000011444,93.6200027466
170318145002,0,0,0,0.0,0.0,0.0
170318145003,701,361,1062,71.4199981689,37.2200012207,62.7799987793
170318146001,950,149,1099,96.3199996948,35.4300003052,64.5699996948
170318146002,816,120,936,70.8000030518,23.2900009155,76.7099990845
170318146003,538,212,750,69.9000015259,36.0400009155,63.9599990845
170318146004,791,134,925,89.1100006104,28.2000007629,71.8000030518
170318146005,716,60,776,69.8499984741,23.9699993134,76.0299987793
170318147001,1005,111,1116,100.0,39.1699981689,60.8300018311
170318147002,899,158,1057,98.9700012207,19.3299999237,80.6699981689
170318147003,431,82,513,46.6399993896,0.0,0.0
170318147004,1000,19,1019,82.5100021362,0.0,100.0
170318147005,1094,0,1094,93.5800018311,1.12000000477,98.8799972534
170318148001,929,277,1206,62.3600006104,10.970000267,89.0299987793
170318148002,1405,43,1448,87.2300033569,2.94000005722,97.0599975586
170318148003,797,34,831,80.9199981689,12.1000003815,87.9000015259
170318148004,813,171,984,98.4000015259,34.0299987793,65.9700012207
170318148005,794,52,846,95.5899963379,32.3100013733,67.6900024414
170318149001,626,260,886,73.4100036621,37.7099990845,62.2900009155
170318149002,1417,29,1446,92.5100021362,20.5400009155,79.4599990845
170318149003,1832,217,2049,100.0,10.279999733,89.7200012207
170318149004,832,511,1343,99.8499984741,47.0099983215,52.9900016785
170318150001,767,211,978,69.8600006104,13.2299995422,86.7699966431
170318150002,951,204,1155,98.3000030518,20.3899993896,79.6100006104
170318150003,666,609,1275,81.7799987793,57.6899986267,42.3100013733
170318151001,1013,151,1164,91.8000030518,13.9399995804,86.0599975586
170318151002,1229,70,1299,97.8199996948,22.0,78.0
170318151003,1440,186,1626,86.4000015259,24.3700008392,75.6299972534
170318152001,1417,169,1586,94.4599990845,17.2399997711,82.7600021362
170318152002,697,321,1018,81.8300018311,34.5099983215,65.4899978638
170318152003,1242,180,1422,100.0,32.5800018311,67.4199981689
170318152004,510,297,807,78.7300033569,33.0999984741,66.9000015259
170318152005,1104,254,1358,87.0500030518,31.9899997711,68.0100021362
170318153001,671,254,925,92.3199996948,35.7099990845,64.2900009155
170318153002,720,191,911,93.3399963379,34.4599990845,65.5400009155
170318153003,318,418,736,82.8799972534,69.7699966431,30.2299995422
170318153004,408,129,537,70.0999984741,27.5400009155,72.4599990845
170318154001,912,138,1050,78.2399978638,22.7199993134,77.2799987793
170318154002,800,57,857,97.2799987793,19.5400009155,80.4599990845
170318154003,1333,96,1429,76.0899963379,6.94000005722,93.0599975586
170318154004,972,64,1036,79.75,10.4499998093,89.5500030518
170318155001,726,558,1284,84.5800018311,37.7200012207,62.2799987793
170318155002,576,279,855,96.6100006104,52.9099998474,47.0900001526
170318155003,664,246,910,91.0899963379,42.2700004578,57.7299995422
170318155004,943,76,1019,92.7200012207,24.2600002289,75.7399978638
170318155005,1000,233,1233,88.0699996948,19.1900005341,80.8099975586
170318155006,1223,90,1313,100.0,43.9199981689,56.0800018311
170318155007,795,0,795,91.4800033569,6.19000005722,93.8099975586
170318156001,469,122,591,71.6399993896,26.9599990845,73.0400009155
170318156002,782,111,893,88.5899963379,24.1000003815,75.9000015259
170318156003,869,243,1112,91.4499969482,57.6500015259,42.3499984741
170318156004,551,38,589,81.8099975586,7.11999988556,92.8799972534
170318156005,520,97,617,51.4599990845,67.6800003052,32.3199996948
170318157011,432,493,925,83.5599975586,63.9599990845,36.0400009155
170318157012,118,271,389,49.6199989319,74.5500030518,25.4500007629
170318157013,230,240,470,44.5099983215,58.3100013733,41.6899986267
170318157014,664,142,806,75.1200027466,28.8199996948,71.1800003052
170318157021,16,26,42,5.75,0.0,0.0
170318157022,220,113,333,28.7099990845,34.4900016785,65.5100021362
170318157023,477,425,902,59.1500015259,75.4199981689,24.5799999237
170318157024,248,470,718,100.0,89.4899978638,10.5100002289
170318157025,359,612,971,95.2900009155,87.4300003052,12.5699996948
170318158001,47,270,317,20.2399997711,84.4899978638,15.5100002289
170318159001,838,215,1053,98.4100036621,0.0,100.0
170318159002,1499,131,1630,100.0,21.5900001526,78.4100036621
170318159003,1415,256,1671,97.9499969482,31.0300006866,68.9700012207
170318160001,860,404,1264,99.2900009155,59.9399986267,40.0600013733
170318160002,742,184,926,85.8199996948,15.8699998856,84.1299972534
170318160003,514,123,637,64.7399978638,17.3299999237,82.6699981689
170318161001,487,121,608,84.0899963379,30.3099994659,69.6900024414
170318161002,1156,0,1156,94.2900009155,3.69000005722,96.3099975586
170318161003,912,0,912,95.0999984741,9.21000003815,90.7900009155
170318161004,883,13,896,92.5599975586,18.6700000763,81.3300018311
170318161005,722,62,784,57.3499984741,8.64999961853,91.3499984741
170318161006,984,91,1075,81.8099975586,38.4599990845,61.5400009155
170318162001,1283,124,1407,77.9100036621,31.4300003052,68.5699996948
170318162002,0,0,0,0.0,8.43000030518,91.5699996948
170318162003,38,0,38,2.58999991417,0.0,100.0
170318163001,420,219,639,72.4499969482,20.7299995422,79.2699966431
170318163002,0,0,0,0.0,0.0,0.0
170318163003,695,0,695,55.3300018311,0.0,100.0
170318163004,864,75,939,85.3600006104,7.94999980927,92.0500030518
170318164011,620,0,620,46.0600013733,0.0,100.0
170318164012,1027,0,1027,94.7399978638,3.43000006676,96.5699996948
170318164013,1084,0,1084,77.9300003052,1.24000000954,98.7600021362
170318164014,1399,0,1399,100.0,2.33999991417,97.6600036621
170318164021,0,0,0,0.0,0.0,0.0
170318164022,670,218,888,70.4800033569,40.2799987793,59.7200012207
170318164023,250,298,548,76.8600006104,51.6199989319,48.3800010681
170318164024,1054,41,1095,98.8300018311,16.7700004578,83.2300033569
170318165001,22,0,22,1.53999996185,7.92000007629,92.0800018311
170318165002,1864,59,1923,92.2699966431,13.3199996948,86.6800003052
170318165003,587,0,587,66.4800033569,0.0,0.0
170318166001,1232,0,1232,97.1600036621,0.0,100.0
170318166002,973,59,1032,67.7600021362,13.3800001144,86.6200027466
170318166003,1993,1,1994,98.4700012207,5.26000022888,94.7399978638
170318167001,700,20,720,65.6299972534,6.69000005722,93.3099975586
170318167002,1455,0,1455,82.9100036621,4.53999996185,95.4599990845
170318168001,1072,154,1226,76.4300003052,14.3299999237,85.6699981689
170318168002,996,359,1355,76.9400024414,37.4900016785,62.5099983215
170318168003,550,144,694,61.2000007629,21.3899993896,78.6100006104
170318168004,454,230,684,74.0299987793,22.7999992371,77.1999969482
170318169001,894,210,1104,92.0,25.3099994659,74.6900024414
170318169002,1029,220,1249,81.6299972534,17.5599994659,82.4400024414
170318169003,943,42,985,76.5899963379,19.5499992371,80.4499969482
170318169004,776,166,942,51.0600013733,12.9600000381,87.0400009155
170318170001,725,9,734,98.7900009155,10.0200004578,89.9800033569
170318170002,772,11,783,94.2200012207,26.8700008392,73.1299972534
170318170003,797,63,860,97.4000015259,35.2099990845,64.7900009155
170318170004,1238,237,1475,95.7200012207,33.6399993896,66.3600006104
170318170005,793,158,951,62.8100013733,15.7700004578,84.2300033569
170318171011,691,232,923,96.3499984741,41.4500007629,58.5499992371
170318171012,346,9,355,29.8299999237,5.92000007629,94.0800018311
170318171013,542,0,542,38.4900016785,1.59000003338,98.4100036621
170318171014,903,0,903,93.0,5.69999980927,94.3000030518
170318171021,1051,44,1095,96.2200012207,15.8000001907,84.1999969482
170318171022,545,166,711,75.6399993896,21.4099998474,78.5899963379
170318171023,428,10,438,39.8199996948,17.3600006104,82.6399993896
170318172001,1438,75,1513,100.0,23.4200000763,76.5800018311
170318172002,636,323,959,98.1600036621,60.6199989319,39.3800010681
170318172003,1005,172,1177,92.9000015259,42.3199996948,57.6800003052
170318172004,256,7,263,28.5599994659,0.0,100.0
170318173001,1844,594,2438,91.6200027466,25.3099994659,74.6900024414
170318174001,824,114,938,100.0,40.5999984741,59.4000015259
170318174002,253,545,798,55.1100006104,89.3899993896,10.6099996567
170318174003,1372,393,1765,97.6200027466,37.3699989319,62.6300010681
170318175001,612,90,702,84.7799987793,41.5200004578,58.4799995422
170318175002,586,129,715,92.7399978638,35.7000007629,64.3000030518
170318175003,773,219,992,98.1200027466,27.6299991608,72.3700027466
170318175004,168,317,485,49.7400016785,68.1699981689,31.8299999237
170318176001,524,466,990,76.6299972534,30.1800003052,69.8199996948
170318176002,1032,153,1185,91.8600006104,44.3699989319,55.6300010681
170318176003,671,437,1108,81.8300018311,52.1300010681,47.8699989319
170318177001,502,433,935,91.7600021362,66.5800018311,33.4199981689
170318177002,814,196,1010,80.0299987793,22.7900009155,77.2099990845
170318177003,710,465,1175,67.2600021362,66.5599975586,33.4399986267
170318177004,533,234,767,83.3700027466,46.0900001526,53.9099998474
170318179001,1128,119,1247,94.4700012207,35.9099998474,64.0899963379
170318179002,208,168,376,29.2199993134,16.8299999237,83.1699981689
170318179003,302,62,364,39.6500015259,8.77000045776,91.2300033569
170318179004,616,213,829,81.2699966431,26.6000003815,73.4000015259
170318179005,879,128,1007,92.9800033569,24.9500007629,75.0500030518
170318180001,1320,343,1663,87.9400024414,27.1900005341,72.8099975586
170318180002,720,144,864,84.2099990845,16.9200000763,83.0800018311
170318180003,842,131,973,71.1800003052,22.6900005341,77.3099975586
170318181001,274,143,417,38.7900009155,36.0200004578,63.9799995422
170318181002,493,246,739,60.1800003052,45.4300003052,54.5699996948
170318182001,733,94,827,79.4400024414,17.0400009155,82.9599990845
170318182002,458,128,586,73.4300003052,25.6000003815,74.4000015259
170318182003,214,46,260,27.8700008392,0.0,0.0
170318182004,1026,214,1240,64.9899978638,14.7399997711,85.2600021362
170318183001,473,184,657,53.5499992371,45.6199989319,54.3800010681
170318183002,1344,93,1437,82.5400009155,18.8099994659,81.1900024414
170318183003,1449,260,1709,93.0299987793,24.7600002289,75.2399978638
170318183004,182,442,624,60.4099998474,75.8199996948,24.1800003052
170318184011,657,19,676,87.7900009155,19.75,80.25
170318184012,548,124,672,77.7799987793,12.0200004578,87.9800033569
170318184013,273,264,537,49.3600006104,42.1899986267,57.8100013733
170318184014,651,158,809,81.8799972534,36.5800018311,63.4199981689
170318184021,261,17,278,36.0999984741,20.8600006104,79.1399993896
170318184022,362,311,673,69.8899993896,41.6800003052,58.3199996948
170318184023,658,340,998,77.7300033569,45.9199981689,54.0800018311
170318185001,373,201,574,41.4099998474,76.8700027466,23.1299991608
170318185002,384,421,805,49.0299987793,46.3300018311,53.6699981689
170318185003,687,455,1142,63.8699989319,48.3699989319,51.6300010681
170318185004,183,217,400,45.7700004578,61.1699981689,38.8300018311
170318186001,183,158,341,28.0200004578,69.9000015259,30.1000003815
170318186002,1164,819,1983,88.8399963379,60.5,39.5
170318186003,374,309,683,53.5699996948,52.0200004578,47.9799995422
170318187001,329,186,515,74.3099975586,72.7399978638,27.2600002289
170318187002,493,209,702,94.7399978638,39.7099990845,60.2900009155
170318187003,220,195,415,32.4000015259,99.0699996948,0.930000007153
170318187004,0,0,0,0.0,0.0,0.0
170318188001,671,209,880,99.6600036621,43.75,56.25
170318188002,371,312,683,86.4599990845,58.7400016785,41.2599983215
170318188003,185,160,345,44.9799995422,44.0200004578,55.9799995422
170318188004,23,94,117,14.5699996948,0.0,0.0
170318188005,459,37,496,40.7599983215,25.2700004578,74.7300033569
170318188006,428,172,600,55.3499984741,42.8899993896,57.1100006104
170318189001,188,0,188,15.1099996567,0.0,100.0
170318189002,690,364,1054,55.8600006104,55.4500007629,44.5499992371
170318189003,554,260,814,69.8700027466,38.9000015259,61.0999984741
170318190001,188,301,489,52.5200004578,88.8199996948,11.1800003052
170318190002,100,490,590,41.7599983215,84.8300018311,15.1700000763
170318190003,173,610,783,60.0900001526,86.5699996948,13.4300003052
170318190004,311,948,1259,82.1800003052,79.9499969482,20.0499992371
170318191001,680,170,850,75.1500015259,79.9400024414,20.0599994659
170318191002,874,190,1064,88.2300033569,47.25,52.75
170318191003,1118,155,1273,98.2300033569,41.6199989319,58.3800010681
170318191004,746,153,899,89.8099975586,11.7600002289,88.2399978638
170318192001,951,49,1000,95.4199981689,12.8500003815,87.1500015259
170318192002,1040,8,1048,64.2600021362,13.6000003815,86.4000015259
170318192003,1220,125,1345,72.1999969482,48.9199981689,51.0800018311
170318192004,1361,202,1563,100.0,33.9000015259,66.0999984741
170318193001,495,16,511,80.8499984741,4.55000019073,95.4499969482
170318193002,1233,8,1241,93.3099975586,28.4599990845,71.5400009155
170318193003,705,9,714,97.0100021362,7.32999992371,92.6699981689
170318194001,821,232,1053,80.75,43.9399986267,56.0600013733
170318194002,1313,295,1608,100.0,22.8400001526,77.1600036621
170318194003,540,87,627,86.2399978638,31.3299999237,68.6699981689
170318194004,605,176,781,81.4400024414,36.8600006104,63.1399993896
170318194005,870,24,894,95.6100006104,14.3400001526,85.6600036621
170318195001,332,147,479,72.8000030518,30.9099998474,69.0899963379
170318195002,184,28,212,25.8199996948,10.9099998474,89.0899963379
170318195003,641,98,739,94.0199966431,13.1300001144,86.8700027466
170318195004,505,324,829,84.9400024414,55.4399986267,44.5600013733
170318196001,97,501,598,70.5999984741,88.3899993896,11.6099996567
170318196002,192,767,959,87.8199996948,95.3399963379,4.65999984741
170318196003,559,455,1014,87.4899978638,50.8699989319,49.1300010681
170318196004,135,489,624,69.5699996948,89.0100021362,10.9899997711
170318197001,35,88,123,11.529999733,0.0,0.0
170318197002,496,1112,1608,74.3099975586,83.6900024414,16.3099994659
170318197003,156,443,599,36.3300018311,69.7099990845,30.2900009155
170318197004,336,665,1001,95.6999969482,76.7099990845,23.2900009155
170318198011,250,490,740,87.9899978638,80.8300018311,19.1700000763
170318198012,253,497,750,77.6399993896,75.9800033569,24.0200004578
170318198013,407,761,1168,84.2699966431,73.3700027466,26.6299991608
170318198014,200,301,501,63.0999984741,74.6999969482,25.2999992371
170318198015,152,646,798,61.6699981689,86.5699996948,13.4300003052
170318198021,276,660,936,78.1299972534,72.3600006104,27.6399993896
170318198022,584,814,1398,95.4300003052,69.4700012207,30.5300006866
170318199001,158,587,745,62.2400016785,69.1800003052,30.8199996948
170318199002,530,460,990,77.8899993896,48.4199981689,51.5800018311
170318199003,340,133,473,47.4900016785,64.8099975586,35.1899986267
170318200001,229,632,861,84.0800018311,68.8099975586,31.1900005341
170318200002,178,813,991,91.25,94.0299987793,5.96999979019
170318201011,484,283,767,92.5199966431,55.0900001526,44.9099998474
170318201012,678,276,954,75.8899993896,34.3499984741,65.6500015259
170318201013,398,318,716,94.0899963379,57.9500007629,42.0499992371
170318201014,388,231,619,91.6999969482,38.0699996948,61.9300003052
170318201015,368,518,886,88.4199981689,69.1900024414,30.8099994659
170318201016,191,790,981,82.5100021362,91.3600006104,8.64000034332
170318201017,613,443,1056,85.7799987793,57.8600006104,42.1399993896
170318201031,667,149,816,97.1399993896,34.7599983215,65.2399978638
170318201032,571,117,688,88.2099990845,19.7800006866,80.2200012207
170318201033,828,252,1080,91.9100036621,27.8400001526,72.1600036621
170318201034,644,347,991,82.9300003052,58.9000015259,41.0999984741
170318201041,754,162,916,91.7799987793,11.6599998474,88.3399963379
170318201042,562,55,617,57.1800003052,10.7399997711,89.2600021362
170318201043,398,302,700,80.0,60.7200012207,39.2799987793
170318201044,517,368,885,73.6299972534,42.7599983215,57.2400016785
170318202011,867,339,1206,77.3099975586,47.1300010681,52.8699989319
170318202012,990,742,1732,71.9599990845,59.8499984741,40.1500015259
170318202013,424,654,1078,84.8799972534,79.8600006104,20.1399993896
170318202014,559,345,904,35.1599998474,48.7200012207,51.2799987793
170318202021,545,23,568,30.1299991608,35.4500007629,64.5500030518
170318202022,662,60,722,87.1999969482,15.3800001144,84.6200027466
170318202023,606,128,734,89.1900024414,23.5499992371,76.4499969482
170318203001,1605,149,1754,97.6600036621,36.0099983215,63.9900016785
170318203002,1054,8,1062,99.5299987793,10.5399999619,89.4599990845
170318203003,703,130,833,83.3000030518,13.8100004196,86.1900024414
170318203004,1109,51,1160,76.4700012207,8.61999988556,91.3799972534
170318204001,995,37,1032,89.7399978638,21.3999996185,78.5999984741
170318204002,1340,127,1467,60.5699996948,8.89000034332,91.1100006104
170318204003,1532,620,2152,100.0,34.0499992371,65.9499969482
170318205011,281,207,488,69.5199966431,28.0100002289,71.9899978638
170318205012,477,190,667,65.3899993896,50.9700012207,49.0299987793
170318205013,820,53,873,83.9400024414,15.0399999619,84.9599990845
170318205014,948,50,998,72.7399978638,8.22999954224,91.7699966431
170318205015,1150,174,1324,68.5999984741,22.2700004578,77.7300033569
170318205021,602,121,723,52.4300003052,7.03999996185,92.9599990845
170318205022,716,16,732,67.3399963379,8.59000015259,91.4100036621
170318205023,1165,0,1165,72.1800003052,0.0,100.0
170318205024,705,0,705,65.8300018311,1.10000002384,98.9000015259
170318206031,567,136,703,55.7900009155,36.5999984741,63.4000015259
170318206032,469,9,478,22.5699996948,3.70000004768,96.3000030518
170318206033,996,116,1112,59.4000015259,11.4399995804,88.5599975586
170318206041,2330,66,2396,85.2399978638,13.1800003052,86.8199996948
170318206042,623,279,902,84.0599975586,27.4400005341,72.5599975586
170318206051,1240,48,1288,81.7799987793,19.2000007629,80.8000030518
170318206052,1040,142,1182,82.5999984741,20.9699993134,79.0299987793
170318206053,1445,0,1445,89.3600006104,4.17999982834,95.8199996948
170318206061,560,482,1042,72.0599975586,47.7700004578,52.2299995422
170318206062,1184,361,1545,69.7200012207,61.0,39.0
170318207001,1551,37,1588,81.3899993896,18.1900005341,81.8099975586
170318207002,179,0,179,14.9799995422,0.300000011921,99.6999969482
170318207003,705,79,784,54.4399986267,16.25,83.75
170318207004,1419,88,1507,74.1299972534,10.9499998093,89.0500030518
170318208001,402,123,525,36.0800018311,16.1000003815,83.9000015259
170318208002,461,60,521,34.2299995422,9.68999958038,90.3099975586
170318208003,253,1,254,34.4599990845,21.1599998474,78.8399963379
170318209011,1251,0,1251,49.7799987793,9.09000015259,90.9100036621
170318209012,967,24,991,79.9800033569,3.34999990463,96.6500015259
170318209013,555,29,584,67.0500030518,7.90999984741,92.0899963379
170318209014,592,213,805,72.5199966431,29.1200008392,70.8799972534
170318209021,432,181,613,67.1399993896,13.3999996185,86.5999984741
170318209022,1327,120,1447,96.7200012207,15.970000267,84.0299987793
170318209023,1037,16,1053,88.9400024414,8.67000007629,91.3300018311
170318209024,867,150,1017,71.6699981689,13.7100000381,86.2900009155
170318210011,531,104,635,43.9799995422,17.7700004578,82.2300033569
170318210012,345,25,370,33.2099990845,16.7800006866,83.2200012207
170318210013,862,68,930,73.5800018311,7.34000015259,92.6600036621
170318210014,898,152,1050,72.6600036621,11.1599998474,88.8399963379
170318210021,907,159,1066,95.0100021362,22.2600002289,77.7399978638
170318210022,671,61,732,71.6200027466,11.3299999237,88.6699981689
170318210023,173,55,228,22.9599990845,0.0,0.0
170318210024,671,56,727,74.0299987793,22.0900001526,77.9100036621
170318210025,573,17,590,40.6599998474,8.19999980927,91.8000030518
170318211011,836,357,1193,85.8300018311,31.2199993134,68.7799987793
170318211012,215,69,284,35.2400016785,36.9900016785,63.0099983215
170318211013,875,165,1040,83.0699996948,28.2399997711,71.7600021362
170318211014,990,164,1154,84.9199981689,29.9599990845,70.0400009155
170318211021,508,80,588,58.3300018311,23.8299999237,76.1699981689
170318211022,712,62,774,68.0100021362,12.6199998856,87.3799972534
170318211023,228,0,228,23.0499992371,0.0,100.0
170318211024,625,91,716,81.6399993896,11.1199998856,88.8799972534
170318212001,452,24,476,46.3499984741,20.7700004578,79.2300033569
170318212002,1262,134,1396,89.7699966431,15.0600004196,84.9400024414
170318212003,2050,112,2162,95.2399978638,20.1100006104,79.8899993896
170318212004,1092,53,1145,100.0,12.6199998856,87.3799972534
170318213001,519,117,636,78.5199966431,19.0900001526,80.9100036621
170318213002,2360,222,2582,95.8799972534,18.5499992371,81.4499969482
170318213003,620,79,699,95.8799972534,28.9599990845,71.0400009155
170318213004,1053,203,1256,99.8399963379,42.9199981689,57.0800018311
170318214011,764,0,764,80.25,19.4599990845,80.5400009155
170318214012,0,0,0,0.0,0.0,0.0
170318214013,462,0,462,71.3000030518,0.0,100.0
170318214014,1085,9,1094,98.0299987793,14.529999733,85.4700012207
170318214021,315,95,410,33.4099998474,58.8199996948,41.1800003052
170318214022,1200,272,1472,96.5199966431,38.0900001526,61.9099998474
170318214023,752,21,773,95.1999969482,18.6299991608,81.3700027466
170318215001,1413,467,1880,79.9000015259,46.2299995422,53.7700004578
170318216001,182,0,182,22.9500007629,55.5800018311,44.4199981689
170318216002,533,104,637,61.5499992371,20.9400005341,79.0599975586
170318216003,0,0,0,0.0,0.0,0.0
170318216004,788,227,1015,77.4800033569,40.6100006104,59.3899993896
170318216005,586,0,586,83.1200027466,3.02999997139,96.9700012207
170318217001,21,0,21,2.99000000954,0.0,0.0
170318217002,505,302,807,71.6100006104,62.2700004578,37.7299995422
170318217003,460,0,460,34.9799995422,0.0,100.0
170318217004,439,74,513,60.0,0.0,0.0
170318217005,791,30,821,92.1399993896,12.9399995804,87.0599975586
170318218001,612,58,670,73.8700027466,8.85999965668,91.1399993896
170318218002,600,97,697,81.4300003052,1.37000000477,98.6299972534
170318218003,601,0,601,83.9400024414,4.26999998093,95.7300033569
170318218004,847,145,992,93.5800018311,17.2299995422,82.7699966431
170318218005,443,3,446,43.1300010681,0.0,100.0
170318218006,608,0,608,80.5299987793,0.0,100.0
170318219001,267,8,275,29.5400009155,6.09000015259,93.9100036621
170318219002,0,0,0,0.0,0.0,0.0
170318219003,754,173,927,71.5800018311,45.2000007629,54.7999992371
170318219004,781,18,799,99.25,14.2899999619,85.7099990845
170318219005,342,78,420,35.3800010681,31.4200000763,68.5800018311
170318220001,642,129,771,93.0,29.6399993896,70.3600006104
170318220002,644,22,666,95.5500030518,4.05000019073,95.9499969482
170318220003,673,102,775,75.3899993896,32.4300003052,67.5699996948
170318220004,445,237,682,72.8600006104,72.4100036621,27.5900001526
170318220005,513,332,845,99.1800003052,47.3300018311,52.6699981689
170318221011,572,244,816,63.9000015259,20.4599990845,79.5400009155
170318221012,528,165,693,57.9399986267,28.75,71.25
170318221013,929,40,969,97.5800018311,15.4899997711,84.5100021362
170318221014,560,0,560,56.7400016785,0.0,100.0
170318221021,573,219,792,68.6900024414,25.0799999237,74.9199981689
170318221022,1286,60,1346,92.3199996948,1.87000000477,98.1299972534
170318221023,659,19,678,56.5900001526,2.47000002861,97.5299987793
170318221024,545,0,545,84.7600021362,3.72000002861,96.2799987793
170318222001,1001,147,1148,64.9300003052,23.0300006866,76.9700012207
170318222002,566,231,797,80.0999984741,48.9199981689,51.0800018311
170318222003,430,169,599,65.3199996948,28.2600002289,71.7399978638
170318223011,738,97,835,77.3099975586,18.1399993896,81.8600006104
170318223012,215,12,227,24.5400009155,15.6099996567,84.3899993896
170318223013,514,133,647,78.8099975586,28.5400009155,71.4599990845
170318223014,405,191,596,58.2599983215,28.8899993896,71.1100006104
170318223021,825,74,899,60.7400016785,14.5600004196,85.4400024414
170318223022,568,44,612,78.9700012207,5.53999996185,94.4599990845
170318223023,974,88,1062,98.3300018311,18.1399993896,81.8600006104
170318223024,887,0,887,84.0,4.88999986649,95.1100006104
170318224001,686,156,842,60.3600006104,22.0900001526,77.9100036621
170318224002,1008,186,1194,65.25,23.9400005341,76.0599975586
170318224003,1585,309,1894,88.6299972534,27.4200000763,72.5800018311
170318224004,275,10,285,34.4599990845,0.0,0.0
170318225001,154,0,154,15.9899997711,0.0,0.0
170318225002,386,134,520,57.9099998474,21.8999996185,78.0999984741
170318225003,1103,5,1108,90.1500015259,18.1399993896,81.8600006104
170318225004,1272,53,1325,97.0699996948,24.2399997711,75.7600021362
170318226011,726,287,1013,62.0299987793,31.2399997711,68.7600021362
170318226012,1091,142,1233,65.9000015259,17.7900009155,82.2099990845
170318226013,416,68,484,48.1599998474,21.6399993896,78.3600006104
170318226021,920,282,1202,83.8799972534,26.7399997711,73.2600021362
170318226022,1063,9,1072,36.2299995422,13.1800003052,86.8199996948
170318226023,674,304,978,37.2299995422,28.3299999237,71.6699981689
170318227011,579,452,1031,77.1699981689,51.3300018311,48.6699981689
170318227012,371,127,498,38.5699996948,35.5499992371,64.4499969482
170318227013,85,1,86,11.529999733,0.0,0.0
170318227014,522,82,604,77.2399978638,14.9899997711,85.0100021362
170318227021,1548,397,1945,85.3099975586,36.2400016785,63.7599983215
170318227022,459,45,504,72.8300018311,20.7299995422,79.2699966431
170318227023,717,20,737,93.6500015259,2.0,98.0
170318228011,1787,11,1798,85.2900009155,1.89999997616,98.0999984741
170318228012,493,35,528,43.1699981689,29.2299995422,70.7699966431
170318228021,371,0,371,21.9899997711,0.0,100.0
170318228022,456,108,564,57.1399993896,20.1000003815,79.9000015259
170318228023,494,299,793,82.6900024414,36.9300003052,63.0699996948
170318229001,898,117,1015,49.2000007629,11.4099998474,88.5899963379
170318230011,1704,18,1722,88.3499984741,11.6599998474,88.3399963379
170318230012,961,52,1013,95.75,5.61000013351,94.3899993896
170318230013,671,123,794,96.1299972534,31.2999992371,68.6999969482
170318230014,742,292,1034,98.1999969482,36.9000015259,63.0999984741
170318230015,138,7,145,8.48999977112,8.51000022888,91.4899978638
170318230021,1072,72,1144,80.6200027466,15.5500001907,84.4499969482
170318230022,0,0,0,0.0,0.0,0.0
170318230023,1345,220,1565,80.8000030518,9.71000003815,90.2900009155
170318230024,1045,18,1063,68.8000030518,6.90000009537,93.0999984741
170318231011,925,49,974,94.9300003052,13.8500003815,86.1500015259
170318231012,549,2,551,65.0500030518,23.7800006866,76.2200012207
170318231013,223,0,223,41.0699996948,0.0,0.0
170318231014,781,84,865,87.1100006104,7.61999988556,92.3799972534
170318231015,658,219,877,88.2300033569,34.4300003052,65.5699996948
170318231021,1829,125,1954,92.7799987793,35.9599990845,64.0400009155
170318231022,1000,310,1310,85.6200027466,43.5699996948,56.4300003052
170318232001,1459,145,1604,74.7799987793,10.5900001526,89.4100036621
170318232002,1005,162,1167,42.4099998474,14.6000003815,85.4000015259
170318233021,821,198,1019,58.2599983215,19.1100006104,80.8899993896
170318233022,1297,252,1549,70.5699996948,25.0300006866,74.9700012207
170318233023,480,246,726,39.8699989319,25.4099998474,74.5899963379
170318233031,622,53,675,85.2300033569,16.0900001526,83.9100036621
170318233032,732,51,783,87.5800018311,13.1800003052,86.8199996948
170318233033,494,79,573,66.4700012207,14.5699996948,85.4300003052
170318233034,0,0,0,0.0,0.0,0.0
170318233035,443,34,477,40.4900016785,26.6200008392,73.3799972534
170318233041,528,59,587,96.8600006104,36.5400009155,63.4599990845
170318233042,728,167,895,90.2200012207,48.2599983215,51.7400016785
170318233043,266,499,765,88.6399993896,55.0099983215,44.9900016785
170318233044,515,353,868,83.0599975586,44.2400016785,55.7599983215
170318233045,754,29,783,92.9899978638,28.5,71.5
170318233046,575,159,734,46.7799987793,15.5900001526,84.4100036621
170318234001,101,14,115,10.9899997711,0.0,100.0
170318234002,377,331,708,45.8499984741,45.8699989319,54.1300010681
170318234003,650,76,726,97.3199996948,34.9900016785,65.0100021362
170318234004,793,219,1012,55.2999992371,37.8199996948,62.1800003052
170318235001,1009,11,1020,84.0199966431,11.8900003433,88.1100006104
170318235002,1034,51,1085,82.8899993896,4.96999979019,95.0299987793
170318235003,973,168,1141,98.7900009155,20.8899993896,79.1100006104
170318235004,590,36,626,80.3600006104,1.51999998093,98.4800033569
170318236021,680,305,985,67.5999984741,20.7299995422,79.2699966431
170318236022,231,100,331,24.1399993896,27.2700004578,72.7300033569
170318236023,363,365,728,36.1599998474,41.9700012207,58.0299987793
170318236024,918,175,1093,77.7399978638,46.9799995422,53.0200004578
170318236031,1535,169,1704,96.9800033569,30.4500007629,69.5500030518
170318236032,768,150,918,94.8300018311,20.4200000763,79.5800018311
170318236041,289,140,429,54.8600006104,43.1800003052,56.8199996948
170318236042,290,250,540,71.1500015259,43.3699989319,56.6300010681
170318236043,765,524,1289,62.7599983215,54.7099990845,45.2900009155
170318236051,500,582,1082,52.1699981689,55.2799987793,44.7200012207
170318236052,817,440,1257,83.8000030518,32.6599998474,67.3399963379
170318236053,754,179,933,96.8799972534,57.2799987793,42.7200012207
170318237021,582,85,667,34.5400009155,18.3700008392,81.6299972534
170318237022,1070,238,1308,63.3100013733,34.8400001526,65.1600036621
170318237023,823,338,1161,62.1899986267,42.4500007629,57.5499992371
170318237024,582,132,714,88.2600021362,38.6500015259,61.3499984741
170318237031,1258,31,1289,86.2799987793,23.0900001526,76.9100036621
170318237032,1109,158,1267,83.0299987793,14.8599996567,85.1399993896
170318237033,2183,385,2568,95.5400009155,23.2999992371,76.6999969482
170318237034,1263,170,1433,65.3099975586,0.0,100.0
170318237041,354,274,628,60.4399986267,59.9799995422,40.0200004578
170318237042,701,236,937,51.4000015259,28.6800003052,71.3199996948
170318237043,469,147,616,53.0999984741,33.2799987793,66.7200012207
170318237051,727,230,957,67.1100006104,26.3500003815,73.6500015259
170318237052,289,43,332,42.5600013733,9.46000003815,90.5400009155
170318237053,487,215,702,77.9100036621,36.6100006104,63.3899993896
170318237054,1007,271,1278,83.2600021362,19.0699996948,80.9300003052
170318238011,802,596,1398,49.7299995422,62.0099983215,37.9900016785
170318238012,802,227,1029,52.8499984741,24.2600002289,75.7399978638
170318238013,397,113,510,50.25,78.8000030518,21.2000007629
170318238031,1555,300,1855,83.6699981689,23.0,77.0
170318238032,753,194,947,76.3099975586,23.8500003815,76.1500015259
170318238033,1036,677,1713,91.0699996948,33.2700004578,66.7300033569
170318238034,805,218,1023,72.1399993896,28.3199996948,71.6800003052
170318238051,469,133,602,55.0800018311,44.7200012207,55.2799987793
170318238052,563,64,627,95.8700027466,3.15000009537,96.8499984741
170318238053,721,321,1042,84.3000030518,37.2700004578,62.7299995422
170318238061,673,57,730,68.2900009155,41.0200004578,58.9799995422
170318238062,436,98,534,61.7299995422,27.2000007629,72.8000030518
170318238063,646,168,814,93.7799987793,41.6699981689,58.3300018311
170318238064,650,177,827,91.6900024414,21.7299995422,78.2699966431
170318239011,891,810,1701,79.2600021362,71.8000030518,28.2000007629
170318239012,618,541,1159,84.1100006104,79.7900009155,20.2099990845
170318239031,620,439,1059,76.3499984741,52.1800003052,47.8199996948
170318239032,155,243,398,40.7799987793,74.3499984741,25.6499996185
170318239033,371,333,704,67.8199996948,54.4900016785,45.5099983215
170318239034,428,573,1001,74.8700027466,66.5100021362,33.4900016785
170318239041,268,195,463,65.7699966431,48.9099998474,51.0900001526
170318239042,241,160,401,49.8800010681,42.5900001526,57.4099998474
170318239043,414,282,696,80.8399963379,66.9599990845,33.0400009155
170318239044,365,768,1133,69.6800003052,66.2300033569,33.7700004578
170318240031,313,347,660,17.7399997711,52.1399993896,47.8600006104
170318240032,188,62,250,23.2299995422,37.1199989319,62.8800010681
170318240033,668,341,1009,66.2099990845,37.5200004578,62.4799995422
170318240041,871,753,1624,62.8499984741,71.4800033569,28.5200004578
170318240042,1247,176,1423,78.9199981689,25.7299995422,74.2699966431
170318240043,379,167,546,56.1199989319,46.9500007629,53.0499992371
170318240051,673,49,722,40.2200012207,12.2399997711,87.7600021362
170318240052,406,24,430,22.1299991608,11.0500001907,88.9499969482
170318240053,508,46,554,30.1900005341,22.0200004578,77.9800033569
170318240061,741,263,1004,56.9199981689,43.9700012207,56.0299987793
170318240062,754,445,1199,57.1199989319,65.9599990845,34.0400009155
170318241051,720,304,1024,42.7400016785,28.9500007629,71.0500030518
170318241052,828,496,1324,42.2900009155,39.0900001526,60.9099998474
170318241053,454,168,622,47.1899986267,29.4099998474,70.5899963379
170318241061,733,390,1123,56.9199981689,69.1699981689,30.8299999237
170318241062,595,337,932,38.4199981689,32.0299987793,67.9700012207
170318241063,765,373,1138,42.8100013733,18.6599998474,81.3399963379
170318241071,396,161,557,70.5999984741,39.9900016785,60.0099983215
170318241072,495,196,691,55.5,30.5300006866,69.4700012207
170318241073,1117,112,1229,58.3300018311,16.5900001526,83.4100036621
170318241074,906,190,1096,46.7200012207,21.6599998474,78.3399963379
170318241081,1436,107,1543,56.8499984741,8.38000011444,91.6200027466
170318241082,1553,314,1867,77.9899978638,25.3500003815,74.6500015259
170318241083,1664,147,1811,61.2700004578,20.6100006104,79.3899993896
170318241131,575,342,917,71.0299987793,51.8699989319,48.1300010681
170318241132,642,290,932,52.6300010681,30.3400001526,69.6600036621
170318241133,1577,263,1840,52.7999992371,21.25,78.75
170318241141,1287,896,2183,68.1500015259,41.0600013733,58.9399986267
170318241142,76,198,274,18.4099998474,67.6699981689,32.3300018311
170318241151,423,359,782,44.0600013733,32.3800010681,67.6200027466
170318241152,298,294,592,27.2099990845,30.9899997711,69.0100021362
170318241161,795,322,1117,76.5100021362,42.1199989319,57.8800010681
170318241162,180,1,181,28.6800003052,1.52999997139,98.4700012207
170318241163,833,274,1107,75.9800033569,34.7000007629,65.3000030518
170318241164,525,261,786,67.6399993896,25.9599990845,74.0400009155
170318241171,1086,169,1255,63.0299987793,9.27999973297,90.7200012207
170318241172,1900,113,2013,54.0800018311,10.6099996567,89.3899993896
170318241173,545,39,584,24.3500003815,10.3199996948,89.6800003052
170318241174,1034,394,1428,81.0400009155,15.0100002289,84.9899978638
170318241191,1247,273,1520,64.1600036621,20.7099990845,79.2900009155
170318241192,1428,318,1746,52.8499984741,25.6599998474,74.3399963379
170318241201,1060,172,1232,44.5200004578,25.25,74.75
170318241202,1110,471,1581,74.0899963379,21.2800006866,78.7200012207
170318241203,807,111,918,55.0,6.36000013351,93.6399993896
170318241204,1526,252,1778,83.8300018311,25.0900001526,74.9100036621
170318241211,1127,187,1314,72.1999969482,27.6100006104,72.3899993896
170318241212,812,76,888,64.1600036621,16.0,84.0
170318241221,1488,124,1612,92.3300018311,20.1599998474,79.8399963379
170318241222,2021,309,2330,87.5,18.5499992371,81.4499969482
170318241223,1460,191,1651,82.0999984741,10.4899997711,89.5100021362
170318241231,172,34,206,20.7199993134,11.5799999237,88.4199981689
170318241232,1255,248,1503,68.9100036621,20.0200004578,79.9800033569
170318241233,1514,286,1800,83.0599975586,25.8799991608,74.1200027466
170318241234,388,248,636,46.9399986267,50.6899986267,49.3100013733
170318241235,720,141,861,82.4700012207,25.3299999237,74.6699981689
170318243001,816,120,936,70.3199996948,30.8500003815,69.1500015259
170318243002,1730,247,1977,92.0800018311,30.6000003815,69.4000015259
170318243003,1149,161,1310,98.7200012207,34.0400009155,65.9599990845
170318244001,1682,56,1738,75.5299987793,15.529999733,84.4700012207
170318245031,653,14,667,85.5100021362,12.3100004196,87.6900024414
170318245032,495,265,760,56.0900001526,35.6100006104,64.3899993896
170318245033,455,151,606,51.1800003052,82.6800003052,17.3199996948
170318245034,785,547,1332,68.2399978638,51.3199996948,48.6800003052
170318245035,700,261,961,65.1999969482,27.5200004578,72.4800033569
170318245051,1273,107,1380,53.2400016785,8.93999958038,91.0599975586
170318245052,453,131,584,29.9200000763,48.0800018311,51.9199981689
170318245053,773,342,1115,48.3499984741,42.8300018311,57.1699981689
170318245061,748,110,858,96.3000030518,30.3199996948,69.6800003052
170318245062,220,126,346,36.0800018311,50.7700004578,49.2299995422
170318245063,1205,299,1504,80.2099990845,54.8499984741,45.1500015259
170318245064,460,426,886,57.7999992371,38.6199989319,61.3800010681
170318245065,925,468,1393,57.8699989319,57.2999992371,42.7000007629
170318245071,1354,531,1885,85.2600021362,34.7099990845,65.2900009155
170318245072,501,401,902,44.7000007629,62.2700004578,37.7299995422
170318246011,644,69,713,55.7900009155,12.1899995804,87.8099975586
170318246012,695,82,777,72.75,35.0900001526,64.9100036621
170318246013,437,207,644,86.6800003052,50.9500007629,49.0499992371
170318246014,696,295,991,75.3000030518,48.1399993896,51.8600006104
170318246021,454,211,665,45.3899993896,14.9799995422,85.0199966431
170318246022,1068,273,1341,78.2799987793,35.0499992371,64.9499969482
170318246023,786,347,1133,69.1299972534,39.5800018311,60.4199981689
170318246024,110,0,110,15.6199998856,0.15000000596,99.8499984741
170318246025,431,38,469,45.5299987793,11.1899995804,88.8099975586
170318247011,1493,244,1737,86.8899993896,14.2700004578,85.7300033569
170318247012,308,50,358,34.2900009155,30.2900009155,69.7099990845
170318247013,650,52,702,77.6500015259,18.7199993134,81.2799987793
170318247021,905,198,1103,80.8700027466,19.0,81.0
170318247022,1106,301,1407,79.2699966431,28.0200004578,71.9800033569
170318247023,259,16,275,11.2100000381,30.1200008392,69.8799972534
170318248001,704,89,793,45.0299987793,9.28999996185,90.7099990845
170318248002,1237,115,1352,63.5900001526,8.68999958038,91.3099975586
170318248003,1075,107,1182,57.5499992371,20.9200000763,79.0800018311
170318248004,1535,226,1761,96.1800003052,34.6599998474,65.3399963379
170318249001,678,394,1072,82.0199966431,37.2799987793,62.7200012207
170318249002,380,374,754,42.4500007629,51.8600006104,48.1399993896
170318250001,854,259,1113,53.2799987793,36.4199981689,63.5800018311
170318250002,854,344,1198,86.6200027466,49.3600006104,50.6399993896
170318250003,905,265,1170,71.8199996948,33.5600013733,66.4400024414
170318252001,271,0,271,40.3300018311,1.57000005245,98.4300003052
170318252002,883,3,886,66.4199981689,20.6100006104,79.3899993896
170318253021,1132,405,1537,78.2600021362,51.8600006104,48.1399993896
170318253022,1424,327,1751,88.7900009155,60.0200004578,39.9799995422
170318253023,819,320,1139,49.3100013733,35.4900016785,64.5100021362
170318253031,1225,136,1361,92.1500015259,24.4200000763,75.5800018311
170318253032,248,229,477,47.5600013733,28.7000007629,71.3000030518
170318253033,490,126,616,91.3899993896,35.2900009155,64.7099990845
170318253034,626,27,653,95.75,28.75,71.25
170318253041,728,55,783,39.1500015259,5.46000003815,94.5400009155
170318253042,745,299,1044,50.6599998474,31.2800006866,68.7200012207
170318254001,302,187,489,30.2999992371,47.6599998474,52.3400001526
170318254002,1426,485,1911,79.2900009155,31.2000007629,68.8000030518
170318254003,995,192,1187,85.3300018311,19.0699996948,80.9300003052
170318255011,593,90,683,84.4300003052,17.9300003052,82.0699996948
170318255012,740,841,1581,61.6100006104,52.6500015259,47.3499984741
170318255013,1148,545,1693,75.5800018311,38.7400016785,61.2599983215
170318255031,261,191,452,52.0699996948,16.6299991608,83.3700027466
170318255032,490,270,760,67.4400024414,44.8800010681,55.1199989319
170318255033,391,350,741,63.1199989319,62.8400001526,37.1599998474
170318255034,696,245,941,61.6599998474,25.5,74.5
170318255035,624,783,1407,75.0400009155,58.2400016785,41.7599983215
170318255041,712,219,931,51.1800003052,30.4400005341,69.5599975586
170318255042,880,308,1188,61.75,37.8499984741,62.1500015259
170318255051,1057,231,1288,84.1800003052,36.3499984741,63.6500015259
170318255052,394,220,614,58.8100013733,58.9500007629,41.0499992371
170318255053,500,286,786,64.9100036621,31.0300006866,68.9700012207
170318255054,776,153,929,52.8400001526,27.8899993896,72.1100006104
170318256001,619,447,1066,68.2900009155,26.4200000763,73.5800018311
170318256002,680,377,1057,54.7400016785,29.0400009155,70.9599990845
170318256003,483,321,804,56.5400009155,48.2299995422,51.7700004578
170318256004,229,214,443,62.0400009155,23.1399993896,76.8600006104
170318257001,447,174,621,80.5400009155,37.6899986267,62.3100013733
170318257002,1296,631,1927,90.1699981689,36.6199989319,63.3800010681
170318257003,851,263,1114,86.4199981689,31.8700008392,68.1299972534
170318258011,636,37,673,89.8499984741,22.0499992371,77.9499969482
170318258012,1017,122,1139,68.7799987793,15.5399999619,84.4599990845
170318258013,965,66,1031,86.1999969482,25.3500003815,74.6500015259
170318258021,1108,0,1108,61.1800003052,0.0,100.0
170318258022,1462,34,1496,84.2799987793,6.34999990463,93.6500015259
170318258023,1712,95,1807,80.8499984741,15.8199996948,84.1800003052
170318258031,1206,0,1206,83.1200027466,14.6499996185,85.3499984741
170318258032,788,0,788,97.2799987793,4.42000007629,95.5800018311
170318258033,749,62,811,75.0899963379,16.5200004578,83.4800033569
170318258034,671,366,1037,88.8600006104,36.0499992371,63.9500007629
170318258035,1027,186,1213,95.3600006104,16.0100002289,83.9899978638
170318259001,970,136,1106,95.5899963379,24.5799999237,75.4199981689
170318259002,940,15,955,86.7399978638,24.9899997711,75.0100021362
170318259003,975,110,1085,94.2699966431,18.0200004578,81.9800033569
170318260001,910,0,910,100.0,12.4499998093,87.5500030518
170318260002,1163,122,1285,99.4599990845,10.3699998856,89.6299972534
170318260003,902,83,985,88.8199996948,16.7000007629,83.3000030518
170318261001,413,0,413,34.5,0.0,100.0
170318261002,73,227,300,35.7999992371,96.0400009155,3.96000003815
170318261003,619,172,791,60.4700012207,49.1899986267,50.8100013733
170318261004,266,0,266,30.4300003052,0.0,100.0
170318261005,639,68,707,67.9800033569,20.2000007629,79.8000030518
170318261006,981,100,1081,88.8199996948,16.1900005341,83.8099975586
170318262011,330,162,492,75.0,64.3700027466,35.6300010681
170318262012,685,122,807,67.3099975586,81.6500015259,18.3500003815
170318262013,359,21,380,82.7900009155,15.4399995804,84.5599975586
170318262014,428,94,522,41.8600006104,18.4200000763,81.5800018311
170318262021,861,629,1490,90.3000030518,49.4199981689,50.5800018311
170318262022,382,344,726,93.3199996948,54.5999984741,45.4000015259
170318262023,676,376,1052,73.3600006104,45.2000007629,54.7999992371
170318262024,375,146,521,85.9700012207,48.2000007629,51.7999992371
170318262025,588,100,688,48.8600006104,4.59999990463,95.4000015259
170318263011,1017,227,1244,86.4499969482,26.1399993896,73.8600006104
170318263012,314,101,415,30.8999996185,28.1800003052,71.8199996948
170318263013,625,171,796,66.5,36.0999984741,63.9000015259
170318263031,246,11,257,25.6499996185,8.59000015259,91.4100036621
170318263032,311,14,325,37.0999984741,10.7600002289,89.2399978638
170318263033,0,0,0,0.0,0.0,0.0
170318263034,711,24,735,61.7099990845,24.6700000763,75.3300018311
170318263041,845,145,990,100.0,24.9400005341,75.0599975586
170318263042,423,173,596,70.0400009155,13.0799999237,86.9199981689
170318263043,1018,307,1325,97.2099990845,51.0499992371,48.9500007629
170318264011,994,639,1633,81.8099975586,48.7299995422,51.2700004578
170318264012,961,711,1672,81.1299972534,36.5400009155,63.4599990845
170318264021,692,253,945,100.0,63.4599990845,36.5400009155
170318264022,539,249,788,87.6500015259,40.8300018311,59.1699981689
170318264023,677,215,892,64.7799987793,35.1599998474,64.8399963379
170318264024,628,317,945,86.4599990845,43.8899993896,56.1100006104
170318264025,228,188,416,51.4199981689,35.8400001526,64.1600036621
170318265001,1304,393,1697,90.6500015259,25.1900005341,74.8099975586
170318265002,568,286,854,96.0599975586,48.5800018311,51.4199981689
170318265003,1199,262,1461,89.8000030518,20.8899993896,79.1100006104
170318265004,316,196,512,32.6300010681,24.2000007629,75.8000030518
170318266001,1064,0,1064,91.25,2.02999997139,97.9700012207
170318266002,797,75,872,76.4199981689,11.6599998474,88.3399963379
170318266003,1079,223,1302,76.2300033569,26.6599998474,73.3399963379
170318266004,405,24,429,50.7700004578,8.09000015259,91.9100036621
170318266005,269,0,269,38.4300003052,0.0,100.0
170318267001,649,106,755,45.5400009155,15.2100000381,84.7900009155
170318267002,572,112,684,37.2299995422,19.2600002289,80.7399978638
170318267003,594,142,736,78.2099990845,26.8600006104,73.1399993896
170318267004,993,15,1008,93.25,25.9899997711,74.0100021362
170318268001,871,103,974,84.3300018311,19.8099994659,80.1900024414
170318268002,1541,235,1776,82.1800003052,33.4500007629,66.5500030518
170318268003,518,306,824,67.6500015259,38.0200004578,61.9799995422
170318268004,389,254,643,68.1900024414,49.2799987793,50.7200012207
170318269011,1468,372,1840,96.7399978638,26.7199993134,73.2799987793
170318269021,427,105,532,97.6100006104,37.1699981689,62.8300018311
170318269022,559,363,922,83.0599975586,57.7299995422,42.2700004578
170318270001,879,44,923,64.5899963379,18.9799995422,81.0199966431
170318270002,944,130,1074,98.9899978638,40.1800003052,59.8199996948
170318270003,938,82,1020,93.8399963379,50.5200004578,49.4799995422
170318271001,777,51,828,97.3000030518,28.2600002289,71.7399978638
170318271002,788,78,866,89.8300018311,14.0600004196,85.9400024414
170318271003,495,261,756,85.5199966431,49.1199989319,50.8800010681
170318272001,620,269,889,56.7000007629,32.4399986267,67.5599975586
170318272002,182,17,199,24.2399997711,14.529999733,85.4700012207
170318272003,370,179,549,61.0699996948,22.1399993896,77.8600006104
170318272004,786,60,846,99.7600021362,25.2399997711,74.7600021362
170318273001,422,1,423,93.1699981689,2.47000002861,97.5299987793
170318273002,477,17,494,39.5200004578,0.0,100.0
170318273003,0,0,0,0.0,0.0,0.0
170318274001,419,141,560,73.3000030518,26.0699996948,73.9300003052
170318274002,997,147,1144,87.3300018311,31.7299995422,68.2699966431
170318274003,550,103,653,79.6299972534,22.9099998474,77.0899963379
170318274004,836,193,1029,72.4100036621,15.4399995804,84.5599975586
170318275001,1083,98,1181,84.3000030518,11.2299995422,88.7699966431
170318275002,2273,68,2341,89.5599975586,17.4699993134,82.5299987793
170318275003,883,269,1152,84.2099990845,22.6100006104,77.3899993896
170318276001,381,353,734,83.0299987793,50.1399993896,49.8600006104
170318276002,1502,236,1738,96.5599975586,20.5599994659,79.4400024414
170318276003,574,137,711,91.0400009155,42.4500007629,57.5499992371
170318277001,1307,362,1669,94.5599975586,39.0099983215,60.9900016785
170318277002,511,300,811,72.5400009155,73.0100021362,26.9899997711
170318278011,339,349,688,79.4499969482,47.2099990845,52.7900009155
170318278012,330,263,593,86.5699996948,52.1199989319,47.8800010681
170318278013,581,190,771,54.5999984741,40.6500015259,59.3499984741
170318278014,1199,429,1628,80.3199996948,35.4300003052,64.5699996948
170318278021,709,23,732,45.9799995422,12.4399995804,87.5599975586
170318278022,892,0,892,50.4799995422,1.21000003815,98.7900009155
170318278041,362,0,362,27.2600002289,0.0,100.0
170318278042,119,0,119,14.1499996185,0.0,0.0
170318278043,261,251,512,45.9199981689,51.6399993896,48.3600006104
170318278051,633,210,843,81.2900009155,22.4200000763,77.5800018311
170318278052,174,0,174,15.0399999619,1.61000001431,98.3899993896
170318278053,230,37,267,38.8100013733,15.8599996567,84.1399993896
170318279011,32,1,33,3.69000005722,12.3999996185,87.5999984741
170318279012,578,2,580,33.1800003052,3.95000004768,96.0500030518
170318279021,221,231,452,75.5899963379,36.8300018311,63.1699981689
170318279022,989,261,1250,93.4199981689,38.2099990845,61.7900009155
170318279023,421,92,513,85.7900009155,30.7099990845,69.2900009155
170318279024,938,109,1047,97.4000015259,24.4099998474,75.5899963379
170318279025,531,96,627,67.4199981689,6.11000013351,93.8899993896
170318280001,645,492,1137,97.1800003052,35.5400009155,64.4599990845
170318280002,659,180,839,82.9100036621,0.0,100.0
170318280003,528,207,735,46.9599990845,27.7399997711,72.2600021362
170318280004,470,180,650,45.8100013733,23.8799991608,76.1200027466
170318281001,402,455,857,98.1699981689,42.9599990845,57.0400009155
170318281002,484,65,549,39.75,8.31999969482,91.6800003052
170318281003,528,200,728,80.9800033569,25.2399997711,74.7600021362
170318281004,607,237,844,89.7900009155,46.9700012207,53.0299987793
170318281005,123,112,235,32.1500015259,48.7000007629,51.2999992371
170318282011,1055,358,1413,60.0499992371,18.5599994659,81.4400024414
170318282012,782,41,823,93.9499969482,11.6800003052,88.3199996948
170318282013,217,169,386,35.3499984741,44.3699989319,55.6300010681
170318282021,65,28,93,7.53000020981,38.9300003052,61.0699996948
170318282022,382,234,616,53.0999984741,50.3499984741,49.6500015259
170318282023,623,192,815,65.1999969482,17.6200008392,82.3799972534
170318282024,482,80,562,59.9799995422,14.5,85.5
170318283001,1380,237,1617,91.1999969482,57.4599990845,42.5400009155
170318283002,933,125,1058,71.0500030518,35.1899986267,64.8099975586
170318284011,587,89,676,81.0599975586,51.0499992371,48.9500007629
170318284012,294,419,713,67.9000015259,30.0100002289,69.9899978638
170318284013,220,264,484,65.9400024414,88.25,11.75
170318284014,649,289,938,89.6699981689,31.0900001526,68.9100036621
170318284021,723,7,730,60.1800003052,9.98999977112,90.0100021362
170318284022,504,465,969,61.4099998474,54.9900016785,45.0099983215
170318284023,420,350,770,73.6800003052,37.3199996948,62.6800003052
170318285031,720,267,987,78.9599990845,14.9499998093,85.0500030518
170318285032,868,93,961,60.1399993896,7.61000013351,92.3899993896
170318285033,148,155,303,37.0,65.7900009155,34.2099990845
170318285034,92,275,367,37.4500007629,79.6200027466,20.3799991608
170318285041,439,93,532,21.9899997711,65.0699996948,34.9300003052
170318285042,65,20,85,6.65999984741,33.0400009155,66.9599990845
170318285043,482,142,624,70.1100006104,10.5500001907,89.4499969482
170318285044,540,497,1037,73.8099975586,54.9700012207,45.0299987793
170318285051,350,145,495,47.5499992371,53.5200004578,46.4799995422
170318285052,291,137,428,46.3699989319,44.3899993896,55.6100006104
170318285053,364,52,416,52.2000007629,7.07999992371,92.9199981689
170318285054,539,156,695,58.8499984741,29.9799995422,70.0199966431
170318285055,1344,353,1697,67.2600021362,36.0600013733,63.9399986267
170318285061,917,76,993,34.1699981689,9.72999954224,90.2699966431
170318285062,449,218,667,56.0,41.4700012207,58.5299987793
170318285063,713,128,841,50.4799995422,23.1599998474,76.8399963379
170318285064,397,94,491,64.1800003052,31.25,68.75
170318285065,594,59,653,79.1500015259,37.2900009155,62.7099990845
170318285066,548,93,641,51.4399986267,9.85999965668,90.1399993896
170318286011,288,441,729,70.2300033569,85.1100006104,14.8900003433
170318286012,226,348,574,54.8199996948,70.1800003052,29.8199996948
170318286013,345,322,667,85.4000015259,63.25,36.75
170318286014,791,467,1258,93.7399978638,56.2599983215,43.7400016785
170318286021,254,805,1059,54.5900001526,88.5299987793,11.470000267
170318286022,405,1094,1499,57.4799995422,85.0500030518,14.9499998093
170318287011,296,431,727,82.9899978638,68.0100021362,31.9899997711
170318287012,539,248,787,68.2600021362,43.3699989319,56.6300010681
170318287013,321,242,563,55.3600006104,65.4000015259,34.5999984741
170318287014,769,170,939,97.4100036621,46.2799987793,53.7200012207
170318287021,1316,142,1458,97.7200012207,25.1200008392,74.8799972534
170318287022,1025,401,1426,80.3799972534,36.8300018311,63.1699981689
170318287023,696,160,856,51.8800010681,64.4300003052,35.5699996948
170318288011,139,613,752,83.0,93.8499984741,6.15000009537
170318288012,206,484,690,83.3300018311,90.5,9.5
170318288013,386,632,1018,67.1100006104,84.4300003052,15.5699996948
170318288014,485,293,778,90.9899978638,53.0099983215,46.9900016785
170318288015,774,79,853,96.2799987793,17.9599990845,82.0400009155
170318288021,546,539,1085,93.6200027466,66.6900024414,33.3100013733
170318288022,289,417,706,65.3700027466,41.0299987793,58.9700012207
170318288023,539,216,755,96.9199981689,45.3499984741,54.6500015259
170318289001,1410,287,1697,92.3300018311,26.6000003815,73.4000015259
170318289002,746,8,754,96.7900009155,9.92000007629,90.0800018311
170318289003,1204,26,1230,96.0899963379,43.8100013733,56.1899986267
170318290001,218,25,243,40.5,11.8400001526,88.1600036621
170318290002,494,83,577,78.9300003052,7.94000005722,92.0599975586
170318291001,620,694,1314,58.8199996948,51.4900016785,48.5099983215
170318291002,1309,68,1377,73.0899963379,14.9399995804,85.0599975586
170318292001,584,364,948,92.0400009155,37.7099990845,62.2900009155
170318292002,884,260,1144,76.9300003052,41.3199996948,58.6800003052
170318292003,790,697,1487,80.6800003052,57.7799987793,42.2200012207
170318292004,526,0,526,33.5699996948,7.01000022888,92.9899978638
170318293011,600,709,1309,84.7200012207,76.4499969482,23.5499992371
170318293012,953,541,1494,61.3600006104,43.1599998474,56.8400001526
170318293021,469,60,529,56.3400001526,16.6100006104,83.3899993896
170318293022,1076,60,1136,74.1500015259,5.5,94.5
170318293023,0,0,0,0.0,0.0,0.0
170318294011,109,31,140,9.98999977112,14.7399997711,85.2600021362
170318294021,480,211,691,78.1699981689,90.0,10.0
170318294022,263,600,863,93.5999984741,78.6399993896,21.3600006104
170318294023,673,731,1404,92.9199981689,76.5299987793,23.4699993134
170318295001,1395,376,1771,71.9000015259,42.8100013733,57.1899986267
170318295002,568,171,739,96.7300033569,37.6800003052,62.3199996948
170318295003,693,112,805,87.5999984741,20.25,79.75
170318296001,448,51,499,37.3800010681,6.94000005722,93.0599975586
170318296002,488,54,542,77.6500015259,11.4099998474,88.5899963379
170318296003,400,144,544,53.1199989319,36.9000015259,63.0999984741
170318297001,193,0,193,20.7099990845,0.0,0.0
170318297002,654,285,939,60.0,30.8600006104,69.1399993896
170318297003,707,350,1057,57.1399993896,31.3899993896,68.6100006104
170318298001,1176,730,1906,82.5100021362,37.9300003052,62.0699996948
170318298002,121,489,610,75.9700012207,94.1399993896,5.86000013351
170318298003,278,367,645,84.1999969482,82.9599990845,17.0400009155
170318298004,240,489,729,53.25,83.6800003052,16.3199996948
170318298005,496,510,1006,64.5699996948,68.3000030518,31.7000007629
170318299011,725,313,1038,48.2099990845,33.8499984741,66.1500015259
170318299012,380,245,625,75.3000030518,48.8300018311,51.1699981689
170318299013,570,450,1020,67.1500015259,64.6999969482,35.2999992371
170318299014,2931,320,3251,76.3700027466,20.4799995422,79.5199966431
170318299021,464,174,638,56.3600006104,44.2799987793,55.7200012207
170318299022,648,186,834,41.7999992371,19.1800003052,80.8199996948
170318299023,975,433,1408,66.4800033569,43.75,56.25
170318299024,574,320,894,79.2600021362,33.1300010681,66.8700027466
170318300011,44,9,53,2.52999997139,43.5299987793,56.4700012207
170318300031,620,309,929,40.9799995422,33.3899993896,66.6100006104
170318300032,401,96,497,28.0900001526,10.6499996185,89.3499984741
170318300033,203,190,393,9.89000034332,13.220000267,86.7799987793
170318300041,591,490,1081,70.6999969482,60.0099983215,39.9900016785
170318300042,336,58,394,27.0,10.9099998474,89.0899963379
170318300043,2467,477,2944,69.8499984741,18.25,81.75
170318300051,814,820,1634,79.4000015259,47.4000015259,52.5999984741
170318300052,308,635,943,49.3499984741,63.3800010681,36.6199989319
170318300061,609,475,1084,70.9400024414,16.7999992371,83.1999969482
170318300062,500,357,857,88.4400024414,66.0199966431,33.9799995422
170318300071,549,224,773,55.8100013733,45.5999984741,54.4000015259
170318300072,1131,175,1306,58.1500015259,17.7299995422,82.2699966431
170318300073,590,460,1050,76.8099975586,45.4300003052,54.5699996948
170318300081,1013,490,1503,65.4599990845,19.0100002289,80.9899978638
170318300082,663,19,682,74.4499969482,15.6999998093,84.3000030518
170318300083,702,190,892,65.25,17.8400001526,82.1600036621
170318301001,343,1131,1474,66.0699996948,78.5800018311,21.4200000763
170318301002,19,7,26,2.31999993324,0.0,0.0
170318302011,957,35,992,56.4599990845,38.2599983215,61.7400016785
170318302012,1369,361,1730,76.1100006104,37.1699981689,62.8300018311
170318302013,240,99,339,25.0900001526,31.4300003052,68.5699996948
170318302021,143,85,228,10.3800001144,25.8299999237,74.1699981689
170318302022,371,508,879,63.7400016785,69.4000015259,30.6000003815
170318303001,499,448,947,71.9100036621,55.4700012207,44.5299987793
170318303002,82,263,345,36.2799987793,39.2400016785,60.7599983215
170318303003,293,893,1186,80.1399993896,81.2099990845,18.7900009155
170318303004,0,0,0,0.0,39.5999984741,60.4000015259
170318304001,262,236,498,72.2799987793,54.3699989319,45.6300010681
170318304002,125,302,427,51.3199996948,73.4000015259,26.6000003815
170318304003,386,560,946,41.7799987793,79.2200012207,20.7800006866
170318304004,52,2,54,8.13000011444,0.0,100.0
170318305001,1045,31,1076,64.9000015259,9.77999973297,90.2200012207
170318305002,398,297,695,37.3899993896,41.5999984741,58.4000015259
170318305003,281,302,583,52.8600006104,23.4899997711,76.5100021362
170318306001,922,0,922,100.0,1.85000002384,98.1500015259
170318306002,1801,18,1819,100.0,14.6000003815,85.4000015259
170318306003,1313,0,1313,100.0,11.2399997711,88.7600021362
170318306004,748,200,948,81.3000030518,70.4599990845,29.5400009155
170318307001,755,9,764,81.8899993896,76.25,23.75
170318307002,778,0,778,97.9800033569,0.0,100.0
170318307003,1330,0,1330,80.8000030518,0.0,100.0
170318307004,817,81,898,100.0,23.7800006866,76.2200012207
170318308001,703,262,965,100.0,26.1000003815,73.9000015259
170318308002,403,141,544,98.5500030518,33.0,67.0
170318308003,863,0,863,100.0,13.8699998856,86.1299972534
170318309001,669,0,669,64.0800018311,9.97999954224,90.0199966431
170318309002,989,46,1035,97.6399993896,27.7399997711,72.2600021362
170318309003,631,32,663,97.3600006104,20.7099990845,79.2900009155
170318310001,775,25,800,98.5199966431,3.50999999046,96.4899978638
170318310002,1210,45,1255,92.6200027466,17.9500007629,82.0500030518
170318311001,1299,40,1339,100.0,14.1599998474,85.8399963379
170318311002,1035,253,1288,91.5400009155,37.6599998474,62.3400001526
170318311003,1617,94,1711,92.9899978638,17.5599994659,82.4400024414
170318311004,2423,118,2541,88.2600021362,11.8900003433,88.1100006104
170318312001,846,4,850,100.0,4.96000003815,95.0400009155
170318312002,1752,108,1860,84.3499984741,6.78999996185,93.2099990845
170318312003,1805,68,1873,93.5999984741,15.9600000381,84.0400009155
170318313001,1223,12,1235,100.0,7.48000001907,92.5199966431
170318314001,695,11,706,98.0599975586,15.0,85.0
170318314002,2157,9,2166,98.4499969482,14.4799995422,85.5199966431
170318315001,2447,97,2544,97.7300033569,8.82999992371,91.1699981689
170318315002,1310,34,1344,95.9300003052,7.11000013351,92.8899993896
170318316001,1025,330,1355,99.7099990845,44.4300003052,55.5699996948
170318316002,927,222,1149,90.8300018311,17.8899993896,82.1100006104
170318316003,882,65,947,88.75,16.1599998474,83.8399963379
170318316004,1198,171,1369,94.5400009155,33.75,66.25
170318316005,1195,115,1310,100.0,27.0200004578,72.9800033569
170318316006,764,0,764,91.5,0.0,100.0
170318317001,2045,12,2057,100.0,7.94999980927,92.0500030518
170318318001,573,90,663,73.1800003052,24.4400005341,75.5599975586
170318318002,904,0,904,99.0100021362,0.0,100.0
170318318003,809,193,1002,76.8399963379,0.0,100.0
170318318004,1073,98,1171,80.8099975586,34.5600013733,65.4400024414
170318318005,1605,191,1796,98.7900009155,37.7000007629,62.2999992371
170318319001,1299,56,1355,94.2900009155,32.7700004578,67.2300033569
170318319002,1241,18,1259,100.0,13.220000267,86.7799987793
170318320001,1797,0,1797,99.6100006104,10.6800003052,89.3199996948
170318321001,1609,0,1609,93.7099990845,10.9799995422,89.0199966431
170318321002,822,0,822,92.1500015259,0.170000001788,99.8300018311
170318321003,696,0,696,94.1800003052,4.30000019073,95.6999969482
170318322001,299,262,561,86.5699996948,55.9799995422,44.0200004578
170318322002,1551,32,1583,99.3099975586,5.01000022888,94.9899978638
170318322003,656,0,656,100.0,2.94000005722,97.0599975586
170318323001,1819,30,1849,100.0,7.59999990463,92.4000015259
170318324001,1229,182,1411,75.25,11.5799999237,88.4199981689
170318324002,1105,43,1148,88.9199981689,3.48000001907,96.5199966431
170318325001,1212,0,1212,93.5899963379,2.93000006676,97.0699996948
170318325002,2131,219,2350,95.7200012207,26.0400009155,73.9599990845
170318326001,707,0,707,100.0,6.13000011444,93.8700027466
170318326002,1047,0,1047,95.2699966431,2.05999994278,97.9400024414
170318326003,1965,5,1970,100.0,11.6800003052,88.3199996948
170318329001,851,536,1387,93.8399963379,54.7299995422,45.2700004578
170318329002,682,33,715,98.7600021362,35.6699981689,64.3300018311
170318330001,1603,10,1613,96.1800003052,4.36999988556,95.6299972534
170318330002,1141,0,1141,98.1100006104,16.8500003815,83.1500015259
170318331001,2814,0,2814,92.4100036621,6.07000017166,93.9300003052
170318331002,1170,0,1170,79.5400009155,22.1200008392,77.8799972534
170318331003,2320,25,2345,98.4899978638,40.1100006104,59.8899993896
170318333001,903,920,1823,81.4899978638,60.6500015259,39.3499984741
170318339001,1127,162,1289,87.2699966431,46.6100006104,53.3899993896
170318339002,1039,154,1193,94.0899963379,23.7399997711,76.2600021362
170318340001,614,407,1021,38.0299987793,48.7599983215,51.2400016785
170318340002,793,58,851,91.9000015259,12.0500001907,87.9499969482
170318342001,1382,0,1382,97.6699981689,3.23000001907,96.7699966431
170318342002,982,51,1033,91.0899963379,17.6800003052,82.3199996948
170318342003,1407,167,1574,97.1600036621,15.0799999237,84.9199981689
170318342004,800,0,800,100.0,11.4099998474,88.5899963379
170318343001,710,327,1037,77.4499969482,45.0900001526,54.9099998474
170318343002,1044,237,1281,82.5400009155,15.1400003433,84.8600006104
170318343003,585,26,611,95.9199981689,19.7999992371,80.1999969482
170318343004,595,0,595,98.1800003052,3.71000003815,96.2900009155
170318343005,732,218,950,80.2399978638,32.2200012207,67.7799987793
170318343006,1070,65,1135,93.1100006104,21.6100006104,78.3899993896
170318344001,634,3,637,98.9100036621,5.09000015259,94.9100036621
170318344002,1354,145,1499,98.75,26.1100006104,73.8899993896
170318344003,1038,412,1450,94.5899963379,45.7200012207,54.2799987793
170318345001,1442,10,1452,98.6399993896,12.4799995422,87.5199966431
170318346001,208,63,271,33.6199989319,59.8699989319,40.1300010681
170318346002,398,175,573,53.0600013733,53.6699981689,46.3300018311
170318346003,476,2,478,100.0,4.82999992371,95.1699981689
170318346004,1277,28,1305,93.9499969482,24.0,76.0
170318347001,490,10,500,100.0,34.4300003052,65.5699996948
170318347002,488,22,510,67.1100006104,67.3199996948,32.6800003052
170318347003,758,34,792,96.0,45.0900001526,54.9099998474
170318348001,316,4,320,61.5400009155,0.119999997318,99.8799972534
170318348002,447,333,780,93.9800033569,28.8899993896,71.1100006104
170318348003,513,0,513,86.3600006104,6.69000005722,93.3099975586
170318349001,588,73,661,91.4199981689,28.3199996948,71.6800003052
170318349002,1491,11,1502,97.0299987793,44.6899986267,55.3100013733
170318350001,1075,0,1075,100.0,0.939999997616,99.0599975586
170318350002,921,0,921,100.0,2.6099998951,97.3899993896
170318350003,433,0,433,28.1000003815,0.0,100.0
170318350004,833,0,833,71.8099975586,0.10000000149,99.9000015259
170318350005,0,0,0,0.0,0.0,0.0
170318351001,1182,58,1240,94.8000030518,40.7099990845,59.2900009155
170318351002,745,133,878,63.5299987793,20.0300006866,79.9700012207
170318351003,423,36,459,38.9000015259,9.32999992371,90.6699981689
170318351004,461,144,605,42.0699996948,24.5100002289,75.4899978638
170318352001,1882,110,1992,97.6900024414,5.01999998093,94.9800033569
170318355001,647,106,753,96.5400009155,8.34000015259,91.6600036621
170318355002,830,31,861,94.9300003052,12.8699998856,87.1299972534
170318356001,553,0,553,100.0,2.29999995232,97.6999969482
170318356002,590,0,590,91.3300018311,5.61999988556,94.3799972534
170318357001,0,0,0,0.0,11.4200000763,88.5800018311
170318358001,1496,50,1546,89.8300018311,38.5600013733,61.4399986267
170318359001,1471,0,1471,97.8700027466,34.3800010681,65.6200027466
170318359002,620,101,721,92.4400024414,42.7299995422,57.2700004578
170318359003,970,22,992,92.4499969482,45.2799987793,54.7200012207
170318360001,524,225,749,97.7799987793,57.6199989319,42.3800010681
170318360002,562,48,610,82.3199996948,12.3199996948,87.6800003052
170318360003,479,63,542,81.6299972534,16.3500003815,83.6500015259
170318361001,920,11,931,93.6600036621,24.1299991608,75.8700027466
170318361002,56,0,56,100.0,14.6899995804,85.3099975586
170318361003,745,26,771,100.0,65.0199966431,34.9799995422
170318362001,854,524,1378,89.5400009155,62.0,38.0
170318363001,404,30,434,84.5999984741,55.2099990845,44.7900009155
170318363002,571,200,771,95.4199981689,61.6300010681,38.3699989319
170318364001,368,563,931,100.0,55.7900009155,44.2099990845
170318364002,722,264,986,100.0,9.77000045776,90.2300033569
170318364003,921,125,1046,96.1399993896,46.7999992371,53.2000007629
170318365001,648,216,864,100.0,67.9700012207,32.0299987793
170318365002,603,28,631,100.0,22.6100006104,77.3899993896
170318366001,1244,56,1300,97.1600036621,23.6299991608,76.3700027466
170318366002,1606,0,1606,98.5299987793,8.84000015259,91.1600036621
170318367001,1195,162,1357,100.0,38.5699996948,61.4300003052
170318367002,980,12,992,98.1200027466,26.9200000763,73.0800018311
170318368001,201,488,689,70.1600036621,69.5899963379,30.4099998474
170318368002,1438,52,1490,88.7399978638,20.8500003815,79.1500015259
170318369001,177,0,177,29.1599998474,3.28999996185,96.7099990845
170318369002,493,0,493,59.8300018311,5.69000005722,94.3099975586
170318370001,1106,0,1106,93.4100036621,17.9500007629,82.0500030518
170318370002,896,0,896,97.0699996948,5.90999984741,94.0899963379
170318371001,510,105,615,94.4700012207,20.3400001526,79.6600036621
170318371002,1056,11,1067,90.3499984741,20.5900001526,79.4100036621
170318373001,1100,53,1153,99.6500015259,15.3999996185,84.5999984741
170318373002,1210,46,1256,96.25,6.67000007629,93.3300018311
170318374001,940,12,952,93.6100006104,9.47999954224,90.5199966431
170318374002,890,8,898,75.1500015259,16.2000007629,83.8000030518
170318378001,1685,0,1685,95.9000015259,9.97999954224,90.0199966431
170318378002,1062,0,1062,100.0,9.64000034332,90.3600006104
170318380001,904,0,904,100.0,27.7299995422,72.2699966431
170318380002,1606,0,1606,98.1100006104,14.9799995422,85.0199966431
170318381001,596,0,596,66.0,17.7199993134,82.2799987793
170318381002,367,0,367,86.7600021362,16.7999992371,83.1999969482
170318381003,0,0,0,0.0,10.8400001526,89.1600036621
170318382001,702,43,745,95.8799972534,18.2999992371,81.6999969482
170318382002,409,278,687,85.1299972534,31.3899993896,68.6100006104
170318383001,888,33,921,88.8099975586,27.1100006104,72.8899993896
170318383002,603,0,603,83.75,14.0200004578,85.9800033569
170318386001,490,74,564,100.0,25.1299991608,74.8700027466
170318386002,1017,0,1017,99.3199996948,15.9300003052,84.0699996948
170318387001,1754,107,1861,98.3600006104,41.4199981689,58.5800018311
170318387002,967,69,1036,94.4400024414,23.3999996185,76.5999984741
170318387003,696,0,696,96.5299987793,5.92000007629,94.0800018311
170318387004,612,16,628,77.4400024414,10.8999996185,89.0999984741
170318388001,642,17,659,98.2099990845,5.96000003815,94.0400009155
170318388002,1482,69,1551,60.5200004578,14.8199996948,85.1800003052
170318390001,2692,4,2696,92.5800018311,9.31999969482,90.6800003052
170318390002,1471,123,1594,71.9599990845,29.8799991608,70.1200027466
170318390003,994,138,1132,95.1299972534,9.10999965668,90.8899993896
170318390004,1412,0,1412,100.0,17.4699993134,82.5299987793
170318391001,2489,0,2489,96.8899993896,0.0,100.0
170318391002,1617,0,1617,90.2799987793,13.7899999619,86.2099990845
170318392001,161,153,314,75.1200027466,40.2799987793,59.7200012207
170318392002,975,219,1194,80.7799987793,60.2000007629,39.7999992371
170318392003,484,315,799,100.0,0.0,0.0
170318395001,1505,9,1514,95.0400009155,27.2700004578,72.7300033569
170318396001,610,1,611,73.6999969482,75.7300033569,24.2700004578
170318396002,1124,0,1124,99.2900009155,13.5699996948,86.4300003052
170318397001,543,13,556,42.6699981689,5.86999988556,94.1299972534
170318397002,1290,13,1303,100.0,7.19999980927,92.8000030518
170318397003,1182,26,1208,67.3700027466,0.0,100.0
170318398001,747,0,747,96.1399993896,0.0,100.0
170318398002,942,0,942,83.8099975586,0.0,100.0
170318398003,680,0,680,80.2799987793,3.78999996185,96.2099990845
170318399001,638,51,689,97.7300033569,16.4799995422,83.5199966431
170318399002,1105,17,1122,96.6399993896,8.0,92.0
170318399003,565,13,578,72.4300003052,0.0,100.0
170318399004,560,0,560,73.3899993896,3.57999992371,96.4199981689
170318399005,691,0,691,98.7099990845,5.65000009537,94.3499984741
170318400001,1278,22,1300,76.7900009155,6.69000005722,93.3099975586
170318400002,639,21,660,71.5100021362,2.98000001907,97.0199966431
170318401001,798,28,826,75.1600036621,0.0,100.0
170318401002,1035,0,1035,55.4099998474,5.48999977112,94.5100021362
170318402001,2004,110,2114,90.0,9.47999954224,90.5199966431
170318403001,743,14,757,82.5500030518,20.4300003052,79.5699996948
170318403002,946,28,974,92.5899963379,7.13000011444,92.8700027466
170318403003,1769,85,1854,93.3099975586,34.5099983215,65.4899978638
170318404001,1335,10,1345,94.9899978638,8.01000022888,91.9899978638
170318404002,1866,0,1866,98.7799987793,6.40999984741,93.5899963379
170318407001,924,0,924,97.2600021362,29.0300006866,70.9700012207
170318407002,1159,10,1169,100.0,58.3100013733,41.6899986267
170318407003,2045,0,2045,96.5500030518,9.32999992371,90.6699981689
170318408001,2085,83,2168,93.9300003052,5.28999996185,94.7099990845
170318408002,792,0,792,59.0999984741,2.46000003815,97.5400009155
170318410001,752,0,752,89.2099990845,17.8600006104,82.1399993896
170318411001,1344,9,1353,81.5100021362,4.42000007629,95.5800018311
170318411002,2132,163,2295,100.0,21.2900009155,78.7099990845
170318411003,1355,32,1387,75.5,23.5,76.5
170318411004,1441,48,1489,92.4800033569,11.529999733,88.4700012207
170318412001,1596,0,1596,100.0,4.92000007629,95.0800018311
170318412002,1287,48,1335,66.7200012207,3.73000001907,96.2699966431
170318412003,759,60,819,45.2200012207,0.0,0.0
170318413001,1142,111,1253,100.0,10.8299999237,89.1699981689
170318413002,1555,77,1632,96.1100006104,21.1900005341,78.8099975586
170318413003,763,16,779,97.5,6.61999988556,93.3799972534
170318413004,757,0,757,100.0,12.9899997711,87.0100021362
170318414001,728,0,728,94.4199981689,3.11999988556,96.8799972534
170318414002,797,0,797,96.2600021362,11.970000267,88.0299987793
170318415001,1303,149,1452,97.7799987793,65.7600021362,34.2400016785
170318415002,1430,0,1430,98.5500030518,9.36999988556,90.6299972534
170318416001,1166,0,1166,99.8300018311,21.1499996185,78.8499984741
170318417001,1355,64,1419,97.3300018311,21.4899997711,78.5100021362
170318418001,614,60,674,100.0,16.0200004578,83.9800033569
170318418002,1326,185,1511,80.8899993896,34.2200012207,65.7799987793
170318419001,717,180,897,50.4199981689,32.3600006104,67.6399993896
170318419002,2911,0,2911,95.0999984741,11.279999733,88.7200012207
170318420001,725,0,725,93.3099975586,25.6200008392,74.3799972534
170318420002,1564,115,1679,81.5800018311,58.5400009155,41.4599990845
170318421001,791,74,865,64.7900009155,10.6700000763,89.3300018311
170318421002,834,11,845,77.7399978638,2.93000006676,97.0699996948
170318421003,702,0,702,75.5699996948,0.0,100.0
170318421004,1169,121,1290,96.4800033569,21.6800003052,78.3199996948
170318421005,1141,7,1148,100.0,20.7999992371,79.1999969482
170318421006,506,138,644,67.7900009155,9.36999988556,90.6299972534
170318422001,2390,11,2401,89.7600021362,8.14999961853,91.8499984741
170318423001,857,125,982,69.9400024414,14.2299995422,85.7699966431
170318423002,1684,2,1686,88.0400009155,6.48999977112,93.5100021362
170318424001,594,151,745,85.0500030518,56.25,43.75
170318424002,1457,213,1670,85.9499969482,18.6200008392,81.3799972534
170318424003,511,26,537,93.8799972534,18.1900005341,81.8099975586
170318425001,2259,151,2410,97.1399993896,15.029999733,84.9700012207
170318426001,984,164,1148,88.6500015259,9.14999961853,90.8499984741
170318426002,942,0,942,97.1100006104,9.73999977112,90.2600021362
170318426003,644,38,682,83.8899993896,15.1899995804,84.8099975586
170318426004,1027,27,1054,97.4100036621,12.0600004196,87.9400024414
170318428001,701,188,889,77.9800033569,24.2299995422,75.7699966431
170318428002,709,307,1016,74.1600036621,22.2900009155,77.7099990845
170318428003,715,413,1128,96.8199996948,45.25,54.75
170318428004,1052,0,1052,99.9100036621,3.45000004768,96.5500030518
170318428005,700,195,895,64.6200027466,27.3199996948,72.6800003052
170318428006,1080,43,1123,79.4800033569,14.9799995422,85.0199966431
170318429001,418,0,418,80.3799972534,6.03999996185,93.9599990845
170318429002,117,0,117,76.4700012207,0.0,100.0
170318429003,1191,0,1191,83.2300033569,6.01999998093,93.9800033569
170318429004,272,12,284,86.5899963379,7.46000003815,92.5400009155
170318430001,1152,0,1152,91.7200012207,33.0900001526,66.9100036621
170318430002,1140,0,1140,99.1299972534,9.17000007629,90.8300018311
170318431001,1179,0,1179,96.4000015259,67.5,32.5
170318431002,569,93,662,97.3499984741,58.5299987793,41.4700012207
170318432001,1518,0,1518,100.0,2.80999994278,97.1900024414
170318432002,1205,0,1205,97.6500015259,5.11000013351,94.8899993896
170318433001,1196,32,1228,100.0,25.4599990845,74.5400009155
170318434001,1234,1,1235,85.1100006104,10.4099998474,89.5899963379
170318435001,9322,285,9607,85.4199981689,25.7800006866,74.2200012207
170318436001,716,568,1284,95.8199996948,40.1899986267,59.8100013733
170318436002,771,228,999,67.4499969482,7.88999986649,92.1100006104
170318437001,809,54,863,92.0,29.1200008392,70.8799972534
170318437002,1130,15,1145,94.6299972534,13.9399995804,86.0599975586
170318438001,1000,34,1034,93.5699996948,16.0200004578,83.9800033569
170318438002,846,65,911,91.5599975586,19.7199993134,80.2799987793
170318439001,768,0,768,91.4300003052,69.2399978638,30.7600002289
170318439002,451,0,451,92.6100006104,14.5200004578,85.4800033569
170318439003,598,11,609,88.7799987793,38.6300010681,61.3699989319
170318439004,384,121,505,86.1800003052,0.0,0.0
170318439005,880,0,880,98.9899978638,2.61999988556,97.3799972534
170319800001,-99999,-99999,-99999,-99999.0,8.84000015259,91.1600036621
170319801001,0,0,0,0.0,4.73000001907,95.2699966431
170438400001,700,568,1268,74.9000015259,65.0899963379,34.9099998474
170438400002,268,358,626,49.1399993896,11.4300003052,88.5699996948
170438401011,657,189,846,66.5100021362,25.6499996185,74.3499984741
170438401012,429,74,503,31.3400001526,16.5599994659,83.4400024414
170438401013,628,308,936,70.2200012207,45.3899993896,54.6100006104
170438401014,800,370,1170,69.3099975586,23.7800006866,76.2200012207
170438401021,967,237,1204,79.5199966431,37.9500007629,62.0499992371
170438401022,351,176,527,37.7000007629,37.6100006104,62.3899993896
170438401023,374,40,414,24.2099990845,17.8600006104,82.1399993896
170438401031,376,498,874,57.8800010681,76.0100021362,23.9899997711
170438401032,1155,110,1265,68.0100021362,16.4799995422,83.5199966431
170438401033,427,368,795,55.0600013733,72.2900009155,27.7099990845
170438401034,898,399,1297,78.6500015259,33.6399993896,66.3600006104
170438401041,763,169,932,72.4700012207,30.9200000763,69.0800018311
170438401042,686,273,959,80.9300003052,27.7999992371,72.1999969482
170438401043,489,63,552,52.9199981689,18.4699993134,81.5299987793
170438401044,1184,0,1184,91.7799987793,0.0,100.0
170438401045,1032,107,1139,76.8600006104,27.4099998474,72.5899963379
170438402011,940,572,1512,81.8600006104,47.1599998474,52.8400001526
170438402012,1136,438,1574,69.8600006104,13.7700004578,86.2300033569
170438402013,1058,649,1707,97.7099990845,33.9599990845,66.0400009155
170438402021,378,370,748,61.1599998474,29.6100006104,70.3899993896
170438402022,805,29,834,66.7699966431,32.7000007629,67.3000030518
170438402023,615,0,615,44.5999984741,0.310000002384,99.6900024414
170438402024,731,227,958,67.3700027466,27.2299995422,72.7699966431
170438403031,143,204,347,38.0099983215,68.2600021362,31.7399997711
170438403032,1073,10,1083,77.5800018311,1.89999997616,98.0999984741
170438403033,1161,167,1328,94.0500030518,43.7999992371,56.2000007629
170438403041,717,209,926,50.7400016785,33.6599998474,66.3399963379
170438403042,285,167,452,43.9300003052,61.2099990845,38.7900009155
170438403043,290,147,437,46.5900001526,21.6800003052,78.3199996948
170438406001,1087,149,1236,97.3199996948,25.4899997711,74.5100021362
170438406002,748,211,959,62.1899986267,35.5800018311,64.4199981689
170438406003,616,245,861,43.3100013733,34.6199989319,65.3799972534
170438407031,763,439,1202,65.6800003052,38.5099983215,61.4900016785
170438407032,838,418,1256,62.3600006104,41.3800010681,58.6199989319
170438407041,369,215,584,57.8800010681,50.5400009155,49.4599990845
170438407042,1349,286,1635,71.4300003052,34.75,65.25
170438407051,1570,94,1664,68.25,14.4899997711,85.5100021362
170438407052,907,173,1080,75.3700027466,35.7299995422,64.2699966431
170438407061,243,23,266,17.0699996948,48.7599983215,51.2400016785
170438407062,920,74,994,57.7900009155,13.8100004196,86.1900024414
170438408011,-99999,-99999,-99999,-99999.0,8.30000019073,91.6999969482
170438408012,460,450,910,95.0899963379,26.6100006104,73.3899993896
170438408013,882,326,1208,85.0100021362,42.9000015259,57.0999984741
170438408021,328,305,633,70.6500015259,56.6599998474,43.3400001526
170438408022,786,145,931,72.4499969482,30.3299999237,69.6699981689
170438408023,802,66,868,70.2300033569,18.8299999237,81.1699981689
170438408024,317,328,645,62.6800003052,76.8899993896,23.1100006104
170438408025,178,158,336,23.8999996185,0.0,0.0
170438409011,836,618,1454,79.4499969482,37.4000015259,62.5999984741
170438409012,744,537,1281,76.1600036621,76.4499969482,23.5499992371
170438409041,1094,243,1337,57.7000007629,20.2099990845,79.7900009155
170438409042,761,188,949,49.7400016785,21.1800003052,78.8199996948
170438409061,1189,34,1223,93.7900009155,10.4300003052,89.5699996948
170438409062,1331,223,1554,96.6999969482,19.1800003052,80.8199996948
170438409071,1038,392,1430,51.2900009155,33.8899993896,66.1100006104
170438409072,1323,465,1788,87.9899978638,29.8999996185,70.0999984741
170438409081,920,113,1033,78.5,32.6899986267,67.3099975586
170438409082,258,101,359,21.9300003052,48.5800018311,51.4199981689
170438409083,470,227,697,50.8800010681,40.6899986267,59.3100013733
170438409101,297,171,468,44.2799987793,45.5900001526,54.4099998474
170438409102,426,335,761,55.9599990845,61.6899986267,38.3100013733
170438409103,689,427,1116,88.2900009155,44.6100006104,55.3899993896
170438409104,1121,0,1121,70.6800003052,7.19999980927,92.8000030518
170438409111,388,528,916,81.4899978638,47.7000007629,52.2999992371
170438409112,902,258,1160,59.2400016785,42.9000015259,57.0999984741
170438410021,495,212,707,35.7099990845,40.6399993896,59.3600006104
170438410022,122,197,319,25.8099994659,61.3699989319,38.6300010681
170438410031,974,141,1115,66.5699996948,36.9300003052,63.0699996948
170438410032,814,158,972,55.6100006104,38.7200012207,61.2799987793
170438410041,597,223,820,54.0200004578,27.6700000763,72.3300018311
170438410042,497,235,732,40.5999984741,36.6599998474,63.3400001526
170438411021,85,0,85,5.28000020981,0.0,0.0
170438411022,1036,102,1138,85.8199996948,2.03999996185,97.9599990845
170438411023,665,20,685,49.0,2.22000002861,97.7799987793
170438411024,1267,88,1355,82.8700027466,7.90999984741,92.0899963379
170438411031,684,59,743,48.6300010681,15.9300003052,84.0699996948
170438411032,416,46,462,37.6199989319,32.6199989319,67.3799972534
170438411033,109,47,156,13.8299999237,41.6399993896,58.3600006104
170438411041,519,318,837,81.5,34.3600006104,65.6399993896
170438411042,63,0,63,6.36000013351,0.0,100.0
170438411043,145,113,258,22.6700000763,74.6600036621,25.3400001526
170438411044,151,314,465,34.4399986267,82.9000015259,17.1000003815
170438411081,859,52,911,61.3899993896,6.40999984741,93.5899963379
170438411082,791,103,894,77.1399993896,15.7299995422,84.2699966431
170438411083,429,67,496,27.7600002289,18.2800006866,81.7200012207
170438411091,193,199,392,38.9700012207,56.2700004578,43.7299995422
170438411092,1038,621,1659,88.2900009155,36.0699996948,63.9300003052
170438411093,658,77,735,66.6399993896,15.5699996948,84.4300003052
170438411101,345,233,578,46.9500007629,50.8800010681,49.1199989319
170438411102,372,202,574,47.7099990845,45.1100006104,54.8899993896
170438411103,56,237,293,27.2600002289,77.0400009155,22.9599990845
170438411111,684,610,1294,68.7200012207,56.6100006104,43.3899993896
170438411112,1192,281,1473,84.9499969482,31.3600006104,68.6399993896
170438411121,1085,479,1564,85.75,45.5299987793,54.4700012207
170438411122,314,138,452,34.3699989319,23.2099990845,76.7900009155
170438411131,454,521,975,57.1500015259,56.8699989319,43.1300010681
170438411132,460,449,909,43.6599998474,33.3899993896,66.6100006104
170438411141,387,386,773,54.4000015259,50.6399993896,49.3600006104
170438411142,311,256,567,51.5900001526,27.1100006104,72.8899993896
170438411143,421,130,551,32.9000015259,44.4900016785,55.5099983215
170438412041,99,14,113,10.2299995422,18.4500007629,81.5500030518
170438412042,790,110,900,72.6399993896,20.1599998474,79.8399963379
170438412043,647,216,863,61.9099998474,32.3699989319,67.6299972534
170438412044,378,208,586,38.5,37.8699989319,62.1300010681
170438412045,285,170,455,48.25,31.7600002289,68.2399978638
170438412051,0,0,0,0.0,0.0,0.0
170438412052,3,0,3,0.180000007153,0.0,0.0
170438412053,0,0,0,0.0,0.0,0.0
170438412061,0,0,0,0.0,0.0,0.0
170438412062,60,177,237,15.0399999619,65.5800018311,34.4199981689
170438412063,1201,181,1382,69.0299987793,17.3700008392,82.6299972534
170438412071,541,666,1207,73.5999984741,63.9500007629,36.0499992371
170438412072,837,148,985,69.0699996948,25.3799991608,74.6200027466
170438412081,702,170,872,39.7099990845,19.3400001526,80.6600036621
170438412082,346,274,620,41.2799987793,49.0,51.0
170438412083,689,238,927,59.6899986267,26.0900001526,73.9100036621
170438412091,409,9,418,20.2600002289,13.6000003815,86.4000015259
170438412092,553,208,761,40.4799995422,16.3999996185,83.5999984741
170438412101,611,354,965,87.9700012207,10.0900001526,89.9100036621
170438412102,1065,95,1160,57.7700004578,18.8999996185,81.0999984741
170438412103,330,340,670,63.3899993896,51.3699989319,48.6300010681
170438413071,0,0,0,0.0,0.0,0.0
170438413072,848,330,1178,68.0899963379,48.6100006104,51.3899993896
170438413073,509,60,569,42.8499984741,10.0,90.0
170438413074,159,83,242,13.2100000381,38.4300003052,61.5699996948
170438413081,372,184,556,48.8100013733,30.2900009155,69.7099990845
170438413082,169,156,325,21.8700008392,49.7799987793,50.2200012207
170438413083,375,331,706,40.25,40.5299987793,59.4700012207
170438413101,769,468,1237,33.5999984741,63.9300003052,36.0699996948
170438413121,1366,348,1714,96.5599975586,2.16000008583,97.8399963379
170438413122,934,269,1203,55.5400009155,17.8099994659,82.1900024414
170438413131,1490,420,1910,68.2900009155,31.6000003815,68.4000015259
170438413141,389,440,829,56.8600006104,64.7699966431,35.2299995422
170438413142,287,43,330,23.8999996185,23.7999992371,76.1999969482
170438413143,987,43,1030,94.4100036621,8.82999992371,91.1699981689
170438413144,367,260,627,44.5,47.9300003052,52.0699996948
170438413145,327,78,405,33.0299987793,42.2299995422,57.7700004578
170438413151,980,249,1229,71.8700027466,36.6599998474,63.3400001526
170438413152,600,146,746,44.5600013733,44.9799995422,55.0200004578
170438413161,663,316,979,53.6100006104,36.9000015259,63.0999984741
170438413162,861,153,1014,54.6300010681,18.6499996185,81.3499984741
170438413181,287,190,477,32.9399986267,55.1399993896,44.8600006104
170438413182,862,182,1044,72.75,25.2700004578,74.7300033569
170438413201,1214,168,1382,96.1699981689,23.2800006866,76.7200012207
170438413202,936,31,967,77.8000030518,32.6399993896,67.3600006104
170438413211,231,343,574,22.7199993134,42.6899986267,57.3100013733
170438413221,459,573,1032,63.2400016785,39.4399986267,60.5600013733
170438413222,1041,194,1235,92.9300003052,34.6399993896,65.3600006104
170438413223,700,99,799,52.1500015259,18.6800003052,81.3199996948
170438413231,844,215,1059,63.5699996948,28.9899997711,71.0100021362
170438413232,910,72,982,71.4199981689,3.46000003815,96.5400009155
170438413241,914,130,1044,70.6399993896,13.8299999237,86.1699981689
170438413242,653,330,983,71.9599990845,30.6399993896,69.3600006104
170438413251,791,127,918,66.9100036621,13.6199998856,86.3799972534
170438413252,260,51,311,28.5799999237,20.2700004578,79.7300033569
170438413253,602,509,1111,66.3700027466,37.2000007629,62.7999992371
170438413254,226,136,362,21.5100002289,39.4799995422,60.5200004578
170438413261,818,314,1132,65.2799987793,31.7199993134,68.2799987793
170438413262,430,190,620,38.0600013733,51.1699981689,48.8300018311
170438413271,892,309,1201,78.3899993896,46.4000015259,53.5999984741
170438413272,590,91,681,49.2099990845,17.8500003815,82.1500015259
170438413273,303,165,468,31.3899993896,58.1300010681,41.8699989319
170438414011,635,365,1000,50.6599998474,88.2799987793,11.720000267
170438414012,460,411,871,65.8899993896,54.9900016785,45.0099983215
170438414013,1163,463,1626,86.6699981689,49.0900001526,50.9099998474
170438414014,907,376,1283,89.1600036621,48.6500015259,51.3499984741
170438414031,260,436,696,52.2900009155,72.4300003052,27.5699996948
170438414032,275,483,758,66.5500030518,71.3099975586,28.6900005341
170438414033,780,560,1340,88.9800033569,52.9900016785,47.0099983215
170438414041,512,589,1101,83.5999984741,46.8300018311,53.1699981689
170438414042,1150,330,1480,78.7699966431,58.0099983215,41.9900016785
170438415011,81,126,207,15.3900003433,47.8400001526,52.1599998474
170438415012,516,109,625,43.7700004578,36.6899986267,63.3100013733
170438415013,512,538,1050,80.5199966431,55.7400016785,44.2599983215
170438415014,405,413,818,40.3800010681,25.1700000763,74.8300018311
170438415031,497,737,1234,71.5400009155,59.4399986267,40.5600013733
170438415032,999,781,1780,81.8799972534,49.9399986267,50.0600013733
170438415041,527,665,1192,72.1100006104,52.5499992371,47.4500007629
170438415042,782,483,1265,76.9899978638,48.3300018311,51.6699981689
170438416031,455,419,874,59.9000015259,68.1100006104,31.8899993896
170438416032,940,203,1143,93.3799972534,59.9799995422,40.0200004578
170438416033,986,418,1404,76.6800003052,71.8000030518,28.2000007629
170438416041,1290,14,1304,65.3300018311,14.2700004578,85.7300033569
170438416042,540,142,682,32.3699989319,29.8899993896,70.1100006104
170438416051,205,256,461,39.5,60.3800010681,39.6199989319
170438416052,860,312,1172,89.4700012207,16.1800003052,83.8199996948
170438416053,241,157,398,29.0499992371,44.9300003052,55.0699996948
170438416061,810,31,841,91.3099975586,27.75,72.25
170438416062,443,238,681,60.3699989319,39.8199996948,60.1800003052
170438416071,670,92,762,52.7700004578,27.6900005341,72.3099975586
170438416072,944,450,1394,90.2300033569,51.9000015259,48.0999984741
170438416073,730,550,1280,73.6100006104,47.8699989319,52.1300010681
170438417031,430,350,780,55.6699981689,46.5,53.5
170438417032,633,0,633,35.6800003052,0.0,100.0
170438417033,1090,92,1182,65.4100036621,16.25,83.75
170438417034,1123,446,1569,71.5500030518,38.9399986267,61.0600013733
170438417041,408,138,546,41.0800018311,11.3100004196,88.6900024414
170438417042,590,291,881,46.9399986267,20.2000007629,79.8000030518
170438417043,141,132,273,19.1200008392,58.0400009155,41.9599990845
170438417051,579,580,1159,94.0,70.2099990845,29.7900009155
170438417052,1296,402,1698,55.1800003052,22.3799991608,77.6200027466
170438417053,542,149,691,58.9099998474,33.75,66.25
170438417061,1534,555,2089,91.3000030518,35.3800010681,64.6200027466
170438417062,1301,420,1721,90.2900009155,17.8600006104,82.1399993896
170438418011,567,333,900,62.9799995422,37.0400009155,62.9599990845
170438418012,420,952,1372,70.6100006104,79.2099990845,20.7900009155
170438418013,687,547,1234,71.9499969482,64.6299972534,35.3699989319
170438418021,775,544,1319,69.7099990845,47.7599983215,52.2400016785
170438418022,434,723,1157,70.2900009155,74.6999969482,25.2999992371
170438418023,256,525,781,50.9500007629,75.1699981689,24.8299999237
170438419011,328,335,663,54.2099990845,55.9700012207,44.0299987793
170438419012,62,338,400,33.3300018311,94.5599975586,5.44000005722
170438419021,724,354,1078,78.8000030518,53.5099983215,46.4900016785
170438419022,593,900,1493,83.1800003052,73.5299987793,26.4699993134
170438419023,95,282,377,38.4300003052,77.8099975586,22.1900005341
170438420001,56,118,174,13.2899999619,65.7799987793,34.2200012207
170438420002,181,479,660,44.8400001526,84.0599975586,15.9399995804
170438420003,342,874,1216,80.0,82.8799972534,17.1200008392
170438421001,229,527,756,66.1999969482,77.1299972534,22.8700008392
170438421002,592,249,841,60.6800003052,44.25,55.75
170438421003,1493,641,2134,94.5500030518,51.2700004578,48.7299995422
170438421004,198,475,673,62.5999984741,79.9800033569,20.0200004578
170438422001,251,357,608,36.2999992371,55.5699996948,44.4300003052
170438422002,329,570,899,80.4800033569,85.0,15.0
170438422003,528,294,822,47.8699989319,52.3400001526,47.6599998474
170438423001,188,653,841,74.0999984741,88.8700027466,11.1300001144
170438423002,328,553,881,71.9800033569,77.3700027466,22.6299991608
170438423003,371,194,565,49.9099998474,39.1800003052,60.8199996948
170438424001,378,506,884,55.9799995422,65.7200012207,34.2799987793
170438424002,492,231,723,61.1699981689,93.7799987793,6.21999979019
170438424003,1242,91,1333,94.0699996948,21.6299991608,78.3700027466
170438424004,283,193,476,52.8899993896,54.3800010681,45.6199989319
170438425001,705,355,1060,69.4199981689,48.3899993896,51.6100006104
170438425002,292,710,1002,64.8099975586,80.5800018311,19.4200000763
170438426011,544,110,654,38.7900009155,18.8600006104,81.1399993896
170438426012,499,199,698,63.6899986267,14.4099998474,85.5899963379
170438426013,166,547,713,52.5,89.0800018311,10.9200000763
170438426021,165,513,678,47.5099983215,80.0599975586,19.9400005341
170438426022,114,428,542,46.7999992371,89.1699981689,10.8299999237
170438426023,328,816,1144,65.3300018311,85.0100021362,14.9899997711
170438426031,681,84,765,39.9500007629,9.71000003815,90.2900009155
170438426032,0,0,0,0.0,0.0,0.0
170438426033,40,9,49,3.98000001907,0.0,0.0
170438426041,334,186,520,47.0999984741,66.3899993896,33.6100006104
170438426042,90,197,287,22.5100002289,48.3300018311,51.6699981689
170438426043,166,431,597,54.1699981689,76.8799972534,23.1200008392
170438426044,488,95,583,70.5800018311,27.3500003815,72.6500015259
170438426051,469,494,963,57.8699989319,60.6699981689,39.3300018311
170438426052,190,487,677,55.7700004578,93.3799972534,6.61999988556
170438426053,660,153,813,66.0400009155,46.5499992371,53.4500007629
170438427021,351,103,454,39.8899993896,11.7399997711,88.2600021362
170438427022,354,494,848,47.6899986267,65.3199996948,34.6800003052
170438427023,791,231,1022,59.1399993896,28.4400005341,71.5599975586
170438427031,563,391,954,66.0199966431,77.1600036621,22.8400001526
170438427032,702,396,1098,92.1900024414,40.1899986267,59.8100013733
170438427033,333,604,937,64.6200027466,70.6699981689,29.3299999237
170438427041,306,0,306,18.5100002289,0.0,100.0
170438427042,578,447,1025,88.3600006104,48.4599990845,51.5400009155
170438427043,125,26,151,16.7800006866,0.0,0.0
170438427044,0,0,0,0.0,0.0,0.0
170438427061,569,683,1252,88.3600006104,62.0900001526,37.9099998474
170438427062,364,623,987,78.5800018311,77.6399993896,22.3600006104
170438427063,654,786,1440,77.6699981689,62.0200004578,37.9799995422
170438427081,195,436,631,59.3600006104,63.4500007629,36.5499992371
170438427082,487,400,887,60.7099990845,53.3199996948,46.6800003052
170438427091,1106,27,1133,86.2300033569,6.71999979019,93.2799987793
170438427092,51,0,51,3.67000007629,0.829999983311,99.1699981689
170438427093,237,258,495,48.5800018311,54.2799987793,45.7200012207
170438427101,345,155,500,47.5299987793,34.7599983215,65.2399978638
170438427102,492,302,794,77.5400009155,36.4900016785,63.5099983215
170438427103,81,92,173,10.5600004196,42.1899986267,57.8100013733
170438427111,371,0,371,25.4500007629,37.1899986267,62.8100013733
170438427112,625,182,807,55.9599990845,35.9799995422,64.0199966431
170438428001,512,275,787,75.6699981689,56.0999984741,43.9000015259
170438428002,257,343,600,57.0900001526,57.6500015259,42.3499984741
170438428003,449,190,639,46.6399993896,46.7299995422,53.2700004578
170438428004,434,191,625,62.5600013733,64.9499969482,35.0499992371
170438429001,655,367,1022,59.0800018311,44.1199989319,55.8800010681
170438429002,538,405,943,44.8400001526,42.9799995422,57.0200004578
170438429003,274,187,461,29.7800006866,63.6899986267,36.3100013733
170438430001,232,236,468,37.0499992371,53.5200004578,46.4799995422
170438430002,697,251,948,57.4199981689,51.5099983215,48.4900016785
170438430003,900,232,1132,90.2699966431,36.5900001526,63.4099998474
170438431001,13,0,13,1.13999998569,0.0,100.0
170438431002,398,119,517,47.9099998474,24.5799999237,75.4199981689
170438431003,602,242,844,54.3800010681,33.9300003052,66.0699996948
170438432001,497,274,771,75.7399978638,23.8099994659,76.1900024414
170438432002,398,550,948,67.5199966431,61.5600013733,38.4399986267
170438432003,556,258,814,51.5200004578,52.75,47.25
170438432004,751,21,772,55.2999992371,8.78999996185,91.2099990845
170438433011,139,172,311,27.7399997711,61.4000015259,38.5999984741
170438433012,692,446,1138,79.8600006104,37.7200012207,62.2799987793
170438433013,779,348,1127,74.8799972534,38.25,61.75
170438433021,538,352,890,50.9399986267,43.9300003052,56.0699996948
170438433022,354,595,949,73.4000015259,81.4300003052,18.5699996948
170438434001,465,263,728,63.5299987793,41.7700004578,58.2299995422
170438434002,193,633,826,67.2600021362,82.1100006104,17.8899993896
170438434003,431,138,569,52.6399993896,44.2000007629,55.7999992371
170438435001,1709,223,1932,95.7900009155,22.6700000763,77.3300018311
170438435002,918,536,1454,78.7600021362,40.1800003052,59.8199996948
170438435003,891,243,1134,74.5599975586,40.8800010681,59.1199989319
170438436011,745,171,916,64.0599975586,28.3400001526,71.6600036621
170438436012,574,280,854,86.0899963379,49.0600013733,50.9399986267
170438436013,368,255,623,59.7299995422,65.4700012207,34.5299987793
170438436021,325,223,548,34.9700012207,50.8300018311,49.1699981689
170438436022,260,348,608,36.6699981689,67.6500015259,32.3499984741
170438437001,85,427,512,38.7000007629,84.0999984741,15.8999996185
170438437002,123,479,602,37.6500015259,83.1699981689,16.8299999237
170438437003,223,598,821,54.6599998474,78.0199966431,21.9799995422
170438438001,1199,201,1400,71.3899993896,19.9099998474,80.0899963379
170438438002,544,943,1487,98.8700027466,67.9300003052,32.0699996948
170438439001,441,274,715,62.7200012207,37.2299995422,62.7700004578
170438439002,160,15,175,12.8900003433,0.0,0.0
170438439003,78,8,86,5.26000022888,0.0,0.0
170438440011,583,298,881,49.9199981689,48.4900016785,51.5099983215
170438440012,909,638,1547,84.5400009155,44.1500015259,55.8499984741
170438440021,430,493,923,78.3499984741,52.4399986267,47.5600013733
170438440022,597,77,674,39.9300003052,16.7299995422,83.2699966431
170438440023,251,821,1072,77.1200027466,88.9300003052,11.0699996948
170438441001,15,12,27,1.90999996662,0.0,0.0
170438441002,401,194,595,48.4099998474,28.4500007629,71.5500030518
170438441003,93,8,101,7.59000015259,0.0,0.0
170438442011,350,105,455,53.3400001526,15.6999998093,84.3000030518
170438442012,1476,229,1705,89.3099975586,24.9300003052,75.0699996948
170438442013,912,601,1513,80.3499984741,60.8499984741,39.1500015259
170438442014,451,212,663,54.75,43.2099990845,56.7900009155
170438442021,425,378,803,56.0,61.4500007629,38.5499992371
170438442022,304,187,491,40.1100006104,36.0800018311,63.9199981689
170438443011,270,186,456,48.7700004578,46.1199989319,53.8800010681
170438443012,1238,392,1630,91.3199996948,16.7900009155,83.2099990845
170438443013,541,190,731,52.1800003052,26.6900005341,73.3099975586
170438443014,1432,376,1808,82.1100006104,23.4400005341,76.5599975586
170438443041,895,285,1180,71.9100036621,23.2299995422,76.7699966431
170438443042,305,334,639,64.2900009155,44.2400016785,55.7599983215
170438443043,790,120,910,79.3399963379,23.8299999237,76.1699981689
170438443051,1074,0,1074,81.5500030518,11.029999733,88.9700012207
170438443052,772,173,945,67.7900009155,35.3300018311,64.6699981689
170438443053,1037,12,1049,92.4199981689,14.9200000763,85.0800018311
170438443061,0,0,0,0.0,0.0,0.0
170438443062,393,17,410,25.2199993134,0.0,0.0
170438443063,1694,281,1975,83.7200012207,23.0900001526,76.9100036621
170438443071,412,186,598,47.3499984741,29.9799995422,70.0199966431
170438443072,648,0,648,99.5400009155,2.57999992371,97.4199981689
170438443073,811,218,1029,70.4800033569,23.6399993896,76.3600006104
170438444011,343,414,757,47.9700012207,71.3700027466,28.6299991608
170438444012,379,477,856,93.7600021362,25.8199996948,74.1800003052
170438444013,496,176,672,69.7799987793,11.0799999237,88.9199981689
170438444021,413,373,786,62.4300003052,43.4399986267,56.5600013733
170438444022,370,320,690,50.8800010681,59.2700004578,40.7299995422
170438444023,494,424,918,79.4100036621,57.5900001526,42.4099998474
170438444024,101,246,347,36.0299987793,84.0999984741,15.8999996185
170438445011,691,101,792,81.8199996948,12.0100002289,87.9899978638
170438445012,813,566,1379,87.6699981689,38.6800003052,61.3199996948
170438445013,321,57,378,89.1500015259,29.8999996185,70.0999984741
170438445021,412,560,972,71.1600036621,57.3600006104,42.6399993896
170438445022,9,3,12,1.42999994755,57.0299987793,42.9700012207
170438445023,236,206,442,47.3199996948,47.1800003052,52.8199996948
170438446011,523,12,535,44.0699996948,15.8000001907,84.1999969482
170438446012,543,725,1268,76.9000015259,55.5499992371,44.4500007629
170438446013,680,59,739,80.5,8.31000041962,91.6900024414
170438446021,996,425,1421,86.2799987793,47.7000007629,52.2999992371
170438446022,699,360,1059,82.3499984741,38.0400009155,61.9599990845
170438446023,1227,240,1467,95.8799972534,13.1800003052,86.8199996948
170438447011,509,108,617,63.1500015259,13.0200004578,86.9800033569
170438447012,256,0,256,25.2700004578,4.0,96.0
170438447013,784,138,922,82.0999984741,26.5499992371,73.4499969482
170438447014,439,216,655,56.4700012207,39.5099983215,60.4900016785
170438447021,591,466,1057,58.6199989319,48.6699981689,51.3300018311
170438447022,523,308,831,62.9099998474,43.3699989319,56.6300010681
170438447023,113,765,878,67.0199966431,96.5699996948,3.43000006676
170438447024,654,65,719,59.6199989319,11.4799995422,88.5199966431
170438448011,410,157,567,44.0900001526,20.3999996185,79.5999984741
170438448012,811,293,1104,69.2600021362,38.3400001526,61.6599998474
170438448013,629,484,1113,84.7699966431,46.1599998474,53.8400001526
170438448021,496,156,652,43.0099983215,12.779999733,87.2200012207
170438448022,732,553,1285,74.9300003052,21.0799999237,78.9199981689
170438449011,938,382,1320,80.8799972534,45.4799995422,54.5200004578
170438449012,367,485,852,52.9900016785,70.1100006104,29.8899993896
170438449021,425,230,655,57.5099983215,44.0200004578,55.9799995422
170438449022,0,0,0,0.0,1.02999997139,98.9700012207
170438449023,456,391,847,53.2400016785,65.9300003052,34.0699996948
170438450001,511,162,673,61.0699996948,39.8800010681,60.1199989319
170438450002,385,283,668,51.9000015259,35.6599998474,64.3399963379
170438450003,623,307,930,61.6699981689,53.0400009155,46.9599990845
170438450004,736,353,1089,79.9599990845,40.0299987793,59.9700012207
170438451001,676,583,1259,87.6699981689,70.3199996948,29.6800003052
170438451002,274,623,897,43.6100006104,66.5,33.5
170438451003,542,257,799,64.2300033569,35.2400016785,64.7600021362
170438451004,109,313,422,26.9099998474,84.0699996948,15.9300003052
170438452001,386,932,1318,86.5400009155,80.5800018311,19.4200000763
170438452002,285,129,414,25.8700008392,27.4899997711,72.5100021362
170438452003,430,503,933,52.8600006104,64.6800003052,35.3199996948
170438453001,456,1059,1515,82.0699996948,85.5500030518,14.4499998093
170438453002,345,584,929,63.4099998474,64.0800018311,35.9199981689
170438454011,444,720,1164,78.7600021362,78.0199966431,21.9799995422
170438454012,288,260,548,80.8300018311,48.2700004578,51.7299995422
170438454013,269,611,880,87.0400009155,83.5199966431,16.4799995422
170438454021,326,689,1015,83.4000015259,82.6200027466,17.3799991608
170438454022,844,690,1534,88.2099990845,61.3699989319,38.6300010681
170438455021,198,249,447,42.2099990845,64.1900024414,35.8100013733
170438455022,349,582,931,56.1199989319,56.1300010681,43.8699989319
170438455023,687,855,1542,69.3000030518,59.6699981689,40.3300018311
170438455051,464,247,711,59.9000015259,29.9899997711,70.0100021362
170438455052,210,449,659,36.5499992371,51.5,48.5
170438455053,397,236,633,41.1800003052,38.8800010681,61.1199989319
170438455061,1036,703,1739,74.9599990845,28.7700004578,71.2300033569
170438455062,769,222,991,63.9399986267,24.3299999237,75.6699981689
170438455071,142,258,400,22.9799995422,77.9000015259,22.1000003815
170438455072,448,379,827,46.7200012207,45.5800018311,54.4199981689
170438455081,981,56,1037,53.9500007629,19.1000003815,80.9000015259
170438455082,360,411,771,49.1399993896,42.75,57.25
170438455091,653,243,896,54.0699996948,37.6399993896,62.3600006104
170438455092,832,328,1160,65.5400009155,41.2099990845,58.7900009155
170438455101,449,299,748,59.1800003052,62.1899986267,37.8100013733
170438455102,494,253,747,37.2000007629,20.1499996185,79.8499984741
170438456011,1277,222,1499,74.9899978638,35.8899993896,64.1100006104
170438456012,519,482,1001,80.3399963379,70.8199996948,29.1800003052
170438456013,286,597,883,75.0199966431,72.6200027466,27.3799991608
170438456021,401,586,987,66.0599975586,67.7200012207,32.2799987793
170438456022,413,681,1094,64.5800018311,78.9499969482,21.0499992371
170438456023,632,768,1400,90.5,66.0500030518,33.9500007629
170438457011,607,458,1065,62.5,44.7900009155,55.2099990845
170438457012,220,294,514,48.8600006104,66.5500030518,33.4500007629
170438457013,154,206,360,31.3899993896,64.2799987793,35.7200012207
170438457021,389,360,749,77.0599975586,78.1699981689,21.8299999237
170438457022,581,301,882,56.7599983215,50.8300018311,49.1699981689
170438457023,595,238,833,62.0299987793,38.5,61.5
170438457024,347,122,469,49.9500007629,30.3999996185,69.5999984741
170438457031,2,3,5,0.519999980927,0.0,0.0
170438457032,463,87,550,55.6699981689,27.6800003052,72.3199996948
170438457033,390,32,422,35.6100006104,21.1000003815,78.9000015259
170438457034,1484,18,1502,94.1100006104,11.4300003052,88.5699996948
170438457041,874,90,964,79.4700012207,6.80999994278,93.1900024414
170438457042,773,155,928,53.6699981689,23.2399997711,76.7600021362
170438457043,517,336,853,47.7299995422,42.9500007629,57.0499992371
170438458021,473,264,737,51.1100006104,26.9699993134,73.0299987793
170438458022,420,245,665,67.1699981689,41.0800018311,58.9199981689
170438458023,418,324,742,58.6599998474,54.4700012207,45.5299987793
170438458031,1302,447,1749,76.1100006104,20.75,79.25
170438458032,843,144,987,50.2799987793,51.7900009155,48.2099990845
170438458033,765,223,988,84.0100021362,34.4799995422,65.5199966431
170438458051,466,370,836,59.8899993896,53.0699996948,46.9300003052
170438458052,244,139,383,45.0099983215,26.1100006104,73.8899993896
170438458053,896,35,931,57.2900009155,22.4099998474,77.5899963379
170438458071,477,142,619,55.7700004578,37.0,63.0
170438458072,338,186,524,38.6100006104,43.8699989319,56.1300010681
170438458073,274,159,433,32.6100006104,52.5800018311,47.4199981689
170438458074,279,379,658,55.8600006104,61.6100006104,38.3899993896
170438458075,671,184,855,70.7799987793,28.6100006104,71.3899993896
170438458081,765,50,815,46.8899993896,20.5799999237,79.4199981689
170438458082,1218,7,1225,57.5699996948,2.6400001049,97.3600006104
170438458091,591,149,740,80.7900009155,20.4699993134,79.5299987793
170438458092,599,138,737,80.9899978638,17.2700004578,82.7300033569
170438458093,1184,132,1316,62.5800018311,28.9099998474,71.0899963379
170438458101,885,417,1302,83.4599990845,42.0800018311,57.9199981689
170438458102,338,79,417,30.3899993896,24.2900009155,75.7099990845
170438458103,791,114,905,73.2799987793,19.0599994659,80.9400024414
170438458111,441,134,575,34.7900009155,23.4699993134,76.5299987793
170438458112,1433,334,1767,82.7200012207,37.9199981689,62.0800018311
170438459011,323,606,929,60.4799995422,74.4599990845,25.5400009155
170438459012,444,449,893,49.2299995422,63.0800018311,36.9199981689
170438459021,806,339,1145,69.8600006104,19.0900001526,80.9100036621
170438459022,826,594,1420,79.7799987793,44.7200012207,55.2799987793
170438460021,817,477,1294,83.6999969482,33.4900016785,66.5100021362
170438460022,737,309,1046,84.8300018311,32.6399993896,67.3600006104
170438460023,727,101,828,62.6800003052,14.1400003433,85.8600006104
170438460031,298,271,569,51.9199981689,79.5699996948,20.4300003052
170438460032,696,487,1183,86.0400009155,44.8400001526,55.1599998474
170438460033,234,230,464,50.1599998474,57.4199981689,42.5800018311
170438460034,610,44,654,74.7399978638,13.1599998474,86.8399963379
170438460041,596,160,756,83.0800018311,42.5699996948,57.4300003052
170438460042,595,326,921,66.2600021362,31.1499996185,68.8499984741
170438460043,711,251,962,91.1800003052,45.8600006104,54.1399993896
170438461021,666,16,682,82.4700012207,31.6599998474,68.3399963379
170438461022,658,330,988,55.2299995422,23.4400005341,76.5599975586
170438461023,1080,181,1261,70.25,17.1000003815,82.9000015259
170438461031,465,323,788,48.25,57.2099990845,42.7900009155
170438461032,805,408,1213,81.9599990845,47.0,53.0
170438461033,248,203,451,39.7400016785,39.6100006104,60.3899993896
170438461034,174,491,665,51.5900001526,80.7200012207,19.2800006866
170438461041,159,364,523,32.9599990845,53.0499992371,46.9500007629
170438461042,826,241,1067,36.7200012207,40.2400016785,59.7599983215
170438461051,337,249,586,53.2200012207,30.0,70.0
170438461052,745,123,868,77.5699996948,16.7399997711,83.2600021362
170438461053,493,43,536,48.1599998474,10.9200000763,89.0800018311
170438461061,1632,413,2045,86.4300003052,23.4300003052,76.5699996948
170438461062,283,101,384,30.5200004578,19.2600002289,80.7399978638
170438462011,599,191,790,53.5999984741,27.6599998474,72.3399963379
170438462012,430,287,717,61.0699996948,53.8899993896,46.1100006104
170438462013,283,418,701,46.4500007629,61.6399993896,38.3600006104
170438462014,507,604,1111,63.8499984741,51.0499992371,48.9500007629
170438462021,999,377,1376,77.8700027466,36.0099983215,63.9900016785
170438462022,720,680,1400,80.1800003052,56.1800003052,43.8199996948
170438462023,608,213,821,66.0999984741,27.3199996948,72.6800003052
170438462024,181,325,506,41.6500015259,62.0999984741,37.9000015259
170438462031,937,363,1300,80.25,39.9000015259,60.0999984741
170438462032,286,314,600,39.4500007629,64.8799972534,35.1199989319
170438462033,450,371,821,72.5299987793,46.5699996948,53.4300003052
170438462051,195,282,477,44.2900009155,61.6199989319,38.3800010681
170438462052,477,348,825,64.5,54.2999992371,45.7000007629
170438462053,436,326,762,58.3499984741,60.2900009155,39.7099990845
170438462061,383,340,723,64.9599990845,51.0800018311,48.9199981689
170438462062,1066,528,1594,90.1600036621,46.1599998474,53.8400001526
170438462063,178,459,637,50.7599983215,78.0199966431,21.9799995422
170438462071,825,438,1263,89.9599990845,44.2700004578,55.7299995422
170438462072,402,564,966,80.9700012207,72.6600036621,27.3400001526
170438462073,389,342,731,50.0,52.5099983215,47.4900016785
170438462074,207,249,456,32.4300003052,48.7200012207,51.2799987793
170438462081,185,186,371,23.0100002289,57.2999992371,42.7000007629
170438462082,82,162,244,14.5699996948,84.1600036621,15.8400001526
170438462091,165,175,340,19.9200000763,77.9899978638,22.0100002289
170438462092,673,339,1012,51.4199981689,40.5299987793,59.4700012207
170438463041,15,10,25,2.36999988556,0.0,0.0
170438463042,908,135,1043,54.5499992371,28.2299995422,71.7699966431
170438463043,676,174,850,81.8099975586,26.7600002289,73.2399978638
170438463044,460,241,701,73.0999984741,53.0800018311,46.9199981689
170438463045,620,232,852,65.1900024414,31.3899993896,68.6100006104
170438463051,134,338,472,31.8500003815,0.0,0.0
170438463052,246,11,257,14.4799995422,0.0,0.0
170438463053,761,237,998,69.2600021362,44.1199989319,55.8800010681
170438463054,243,50,293,27.4300003052,16.6700000763,83.3300018311
170438463071,863,187,1050,75.4300003052,20.1200008392,79.8799972534
170438463072,1197,379,1576,85.75,29.0100002289,70.9899978638
170438463073,675,633,1308,80.7900009155,30.2900009155,69.7099990845
170438463081,2022,40,2062,93.4700012207,13.5100002289,86.4899978638
170438463082,914,163,1077,94.3899993896,21.0699996948,78.9300003052
170438463101,1664,314,1978,70.4700012207,15.9099998474,84.0899963379
170438463102,989,199,1188,70.3799972534,25.9400005341,74.0599975586
170438463111,424,193,617,57.9300003052,26.0300006866,73.9700012207
170438463112,1006,396,1402,66.3199996948,54.2000007629,45.7999992371
170438463113,408,454,862,84.0199966431,80.2300033569,19.7700004578
170438463114,244,245,489,42.1199989319,55.2400016785,44.7599983215
170438463121,126,42,168,11.7899999619,0.0,0.0
170438463122,594,190,784,51.3100013733,40.4000015259,59.5999984741
170438463123,223,209,432,31.5599994659,51.4799995422,48.5200004578
170438463131,794,88,882,37.4799995422,13.3500003815,86.6500015259
170438463132,322,424,746,69.0699996948,57.1300010681,42.8699989319
170438463133,207,236,443,30.8099994659,67.7200012207,32.2799987793
170438463141,1100,219,1319,74.5199966431,26.8099994659,73.1900024414
170438463142,653,325,978,67.4000015259,49.9700012207,50.0299987793
170438463151,249,307,556,43.2999992371,52.0600013733,47.9399986267
170438463152,335,160,495,41.4599990845,45.8199996948,54.1800003052
170438463153,495,401,896,49.0400009155,55.9599990845,44.0400009155
170438464041,755,565,1320,97.1999969482,50.5,49.5
170438464042,932,308,1240,81.4199981689,17.1100006104,82.8899993896
170438464043,754,501,1255,81.1800003052,51.5099983215,48.4900016785
170438464044,798,104,902,59.6599998474,16.9300003052,83.0699996948
170438464051,66,72,138,6.78000020981,0.0,0.0
170438464052,731,379,1110,64.8000030518,18.9099998474,81.0899963379
170438464081,1447,77,1524,66.4300003052,5.82000017166,94.1800003052
170438464082,952,139,1091,59.3300018311,37.6500015259,62.3499984741
170438464091,34,0,34,1.53999996185,0.939999997616,99.0599975586
170438464092,461,288,749,32.2599983215,18.8999996185,81.0999984741
170438464101,1914,433,2347,84.2399978638,18.7600002289,81.2399978638
170438464102,525,211,736,35.7999992371,38.5499992371,61.4500007629
170438464111,1151,158,1309,43.5200004578,29.5900001526,70.4100036621
170438464112,643,73,716,71.0299987793,5.71000003815,94.2900009155
170438464121,486,145,631,52.1100006104,30.4899997711,69.5100021362
170438464122,420,26,446,37.0400009155,6.11999988556,93.8799972534
170438464123,1645,0,1645,71.2399978638,2.52999997139,97.4700012207
170438464131,1275,274,1549,87.9599990845,13.3100004196,86.6900024414
170438464132,85,27,112,5.90000009537,4.44000005722,95.5599975586
170438465041,451,44,495,33.0699996948,17.9799995422,82.0199966431
170438465042,689,585,1274,72.6800003052,52.2900009155,47.7099990845
170438465043,273,301,574,45.8800010681,54.1100006104,45.8899993896
170438465044,1051,235,1286,72.4899978638,26.8400001526,73.1600036621
170438465071,633,0,633,22.3700008392,2.33999991417,97.6600036621
170438465091,363,54,417,43.0800018311,27.4699993134,72.5299987793
170438465092,558,208,766,50.8600006104,0.0,0.0
170438465093,869,58,927,49.4099998474,3.56999993324,96.4300003052
170438465101,397,164,561,32.8800010681,13.970000267,86.0299987793
170438465102,1127,116,1243,84.3300018311,10.6899995804,89.3099975586
170438465111,1482,218,1700,88.3099975586,31.2999992371,68.6999969482
170438465112,380,88,468,28.9400005341,15.6700000763,84.3300018311
170438465113,1340,167,1507,80.9800033569,36.4900016785,63.5099983215
170438465114,647,21,668,62.0200004578,5.01000022888,94.9899978638
170438465131,641,23,664,39.4799995422,6.80999994278,93.1900024414
170438465132,330,309,639,54.8499984741,34.0400009155,65.9599990845
170438465141,646,31,677,47.3400001526,8.81999969482,91.1800003052
170438465142,1082,103,1185,43.6500015259,7.48999977112,92.5100021362
170438465151,1115,31,1146,97.3700027466,8.36999988556,91.6299972534
170438465152,312,157,469,40.5,24.9200000763,75.0800018311
170438465153,570,178,748,58.7099990845,28.5499992371,71.4499969482
170438465154,486,255,741,42.2200012207,46.8199996948,53.1800003052
170438465171,553,233,786,58.4399986267,33.9000015259,66.0999984741
170438465172,1487,108,1595,70.0800018311,10.6700000763,89.3300018311
170438465173,724,150,874,36.0099983215,20.3600006104,79.6399993896
170438465181,0,0,0,0.0,0.0,0.0
170438465182,487,445,932,68.3799972534,34.2200012207,65.7799987793
170438465183,194,453,647,45.1199989319,65.6399993896,34.3600006104
170438465191,557,452,1009,87.8899993896,48.3600006104,51.6399993896
170438465192,1645,11,1656,84.1500015259,5.23000001907,94.7699966431
170438465211,200,67,267,23.1599998474,24.7900009155,75.2099990845
170438465212,531,119,650,55.4599990845,27.4200000763,72.5800018311
170438465213,640,70,710,51.9399986267,17.4200000763,82.5800018311
170438465214,375,142,517,33.8800010681,24.6399993896,75.3600006104
170438465221,1310,22,1332,77.3099975586,5.96000003815,94.0400009155
170438465222,1146,2,1148,70.7799987793,1.86000001431,98.1399993896
170438465231,684,396,1080,78.4899978638,41.0900001526,58.9099998474
170438465232,500,337,837,65.5999984741,45.7000007629,54.2999992371
170438465241,928,93,1021,75.1800003052,12.6199998856,87.3799972534
170438465242,422,226,648,48.8300018311,60.7799987793,39.2200012207
170438465243,1085,58,1143,56.1699981689,13.75,86.25
170438466031,572,174,746,62.3699989319,35.3100013733,64.6900024414
170438466032,557,479,1036,67.0999984741,57.0900001526,42.9099998474
170438466033,627,71,698,46.4700012207,22.8400001526,77.1600036621
170438466041,1084,315,1399,83.2200012207,27.7099990845,72.2900009155
170438466042,74,367,441,42.1199989319,100.0,0.0
170438466043,841,275,1116,97.9800033569,45.5099983215,54.4900016785
170438467011,1372,389,1761,85.4899978638,28.6399993896,71.3600006104
170438467012,693,343,1036,93.4199981689,37.1699981689,62.8300018311
170438467013,620,206,826,84.8899993896,29.0699996948,70.9300003052
170438467021,668,195,863,71.0299987793,21.25,78.75
170438467022,627,82,709,51.7900009155,26.1100006104,73.8899993896
170438467023,846,64,910,58.6300010681,17.2099990845,82.7900009155
170898501011,851,872,1723,79.4700012207,56.8800010681,43.1199989319
170898501012,1177,721,1898,41.4000015259,74.6100006104,25.3899993896
170898501031,1695,375,2070,53.3100013733,38.4099998474,61.5900001526
170898501032,516,683,1199,71.5800018311,49.9399986267,50.0600013733
170898501051,509,232,741,32.2900009155,10.9099998474,89.0899963379
170898501052,1363,581,1944,41.9799995422,42.7400016785,57.2599983215
170898501061,131,711,842,58.6399993896,87.5999984741,12.3999996185
170898501062,537,137,674,71.6299972534,38.6300010681,61.3699989319
170898501063,171,269,440,13.5699996948,57.9399986267,42.0600013733
170898501064,1178,343,1521,69.6399993896,56.0499992371,43.9500007629
170898502011,662,912,1574,59.5800018311,72.6399993896,27.3600006104
170898502012,293,128,421,30.0699996948,42.5900001526,57.4099998474
170898502021,431,47,478,38.5800018311,15.3400001526,84.6600036621
170898502022,470,103,573,19.2299995422,74.3799972534,25.6200008392
170898502023,239,691,930,33.7599983215,49.9900016785,50.0099983215
170898503011,46,891,937,42.1100006104,95.7300033569,4.26999998093
170898503012,957,419,1376,52.9399986267,25.6700000763,74.3300018311
170898503013,132,234,366,37.8499984741,86.6600036621,13.3400001526
170898503014,1164,539,1703,77.7600021362,38.75,61.25
170898503021,690,145,835,30.5900001526,13.75,86.25
170898503022,738,888,1626,72.5899963379,59.8199996948,40.1800003052
170898504001,861,245,1106,88.1999969482,33.6599998474,66.3399963379
170898504002,292,323,615,59.4199981689,61.3699989319,38.6300010681
170898505001,396,333,729,80.8199996948,44.0699996948,55.9300003052
170898505002,377,338,715,76.8799972534,60.3300018311,39.6699981689
170898505003,11,141,152,21.5300006866,17.0699996948,82.9300003052
170898505004,433,151,584,55.6199989319,45.9700012207,54.0299987793
170898506001,770,273,1043,36.3400001526,61.7000007629,38.2999992371
170898506002,584,511,1095,39.7200012207,38.3499984741,61.6500015259
170898506003,535,251,786,47.5499992371,26.7299995422,73.2699966431
170898507011,1092,148,1240,61.2999992371,15.7399997711,84.2600021362
170898507012,2637,622,3259,29.4400005341,22.3199996948,77.6800003052
170898507013,1155,397,1552,48.2400016785,24.4300003052,75.5699996948
170898507014,901,251,1152,50.7900009155,20.5100002289,79.4899978638
170898507021,-99998,-99998,-99998,-99998.0,-99998.0,-99998.0
170898507022,854,294,1148,39.1300010681,25.1599998474,74.8399963379
170898507023,568,237,805,63.6399993896,29.3199996948,70.6800003052
170898507024,-99998,-99998,-99998,-99998.0,-99998.0,-99998.0
170898507031,-99998,-99998,-99998,-99998.0,-99998.0,-99998.0
170898507032,458,51,509,85.2600021362,27.6200008392,72.3799972534
170898508001,513,171,684,92.6800003052,61.8300018311,38.1699981689
170898508002,2,0,2,0.15000000596,0.0,0.0
170898508003,1444,292,1736,93.8899993896,43.5400009155,56.4599990845
170898508004,626,417,1043,95.5999984741,65.3799972534,34.6199989319
170898508005,556,326,882,72.1800003052,60.4799995422,39.5200004578
170898508006,98,365,463,46.4900016785,79.3600006104,20.6399993896
170898510001,1169,652,1821,70.2300033569,59.5299987793,40.4700012207
170898510002,984,548,1532,63.8300018311,47.4099998474,52.5900001526
170898510003,525,182,707,54.0900001526,25.7600002289,74.2399978638
170898511011,523,118,641,97.4199981689,49.6500015259,50.3499984741
170898511012,360,240,600,60.6100006104,45.8400001526,54.1599998474
170898511013,409,435,844,61.5600013733,55.5699996948,44.4300003052
170898511014,351,282,633,94.0599975586,58.9700012207,41.0299987793
170898511015,3,46,49,6.09000015259,0.0,0.0
170898511021,841,424,1265,86.5800018311,63.4099998474,36.5900001526
170898511022,496,330,826,80.1200027466,50.7200012207,49.2799987793
170898511023,275,504,779,60.9099998474,77.5999984741,22.3999996185
170898513011,177,301,478,51.4500007629,20.5,79.5
170898513012,1364,532,1896,100.0,48.8699989319,51.1300010681
170898513013,287,602,889,80.9700012207,78.5500030518,21.4500007629
170898513021,773,158,931,93.4700012207,51.4199981689,48.5800018311
170898513022,272,44,316,38.2599983215,26.9099998474,73.0899963379
170898513023,472,108,580,55.7200012207,15.6599998474,84.3399963379
170898513024,444,64,508,84.5299987793,31.9799995422,68.0199966431
170898514001,526,352,878,81.3700027466,76.3199996948,23.6800003052
170898514002,856,578,1434,100.0,64.8700027466,35.1300010681
170898514003,812,222,1034,98.5699996948,56.5900001526,43.4099998474
170898514004,921,446,1367,98.6999969482,55.4700012207,44.5299987793
170898514005,449,622,1071,94.1100006104,74.0100021362,25.9899997711
170898514006,572,276,848,86.3499984741,73.9800033569,26.0200004578
170898515001,959,255,1214,95.7399978638,39.0699996948,60.9300003052
170898516001,660,662,1322,63.1300010681,46.5600013733,53.4399986267
170898516002,176,131,307,29.6299991608,0.0,0.0
170898516003,395,624,1019,98.1699981689,78.0999984741,21.8999996185
170898516004,249,1021,1270,95.6299972534,88.1399993896,11.8599996567
170898516005,0,0,0,0.0,0.0,0.0
170898518011,1065,454,1519,57.1100006104,34.3100013733,65.6900024414
170898518012,674,519,1193,89.9700012207,38.1100006104,61.8899993896
170898518013,727,322,1049,88.8199996948,43.2999992371,56.7000007629
170898518014,929,732,1661,72.7200012207,46.3499984741,53.6500015259
170898519041,1297,257,1554,80.0199966431,20.2299995422,79.7699966431
170898519042,959,365,1324,81.3799972534,50.5800018311,49.4199981689
170898519043,782,439,1221,62.1399993896,36.3499984741,63.6500015259
170898519044,913,211,1124,58.2400016785,28.4699993134,71.5299987793
170898519051,2707,183,2890,34.2999992371,11.7299995422,88.2699966431
170898519052,872,313,1185,36.4099998474,33.0499992371,66.9499969482
170898519071,524,139,663,78.5500030518,16.2199993134,83.7799987793
170898519072,1691,388,2079,63.5200004578,22.0300006866,77.9700012207
170898519073,2219,78,2297,69.9700012207,7.94999980927,92.0500030518
170898519081,334,28,362,18.5499992371,9.60000038147,90.4000015259
170898519082,401,7,408,29.0400009155,8.55000019073,91.4499969482
170898519083,789,414,1203,66.2399978638,28.9500007629,71.0500030518
170898519091,102,323,425,66.1999969482,85.5500030518,14.4499998093
170898519092,412,325,737,93.4100036621,66.3899993896,33.6100006104
170898519093,379,410,789,29.0799999237,54.1699981689,45.8300018311
170898519101,415,106,521,43.7400016785,27.4099998474,72.5899963379
170898519102,144,92,236,15.3299999237,48.3800010681,51.6199989319
170898519103,512,288,800,63.6899986267,35.5999984741,64.4000015259
170898520011,132,135,267,31.6000003815,34.2900009155,65.7099990845
170898520012,259,362,621,54.2400016785,69.8000030518,30.2000007629
170898520013,203,363,566,37.0400009155,56.7900009155,43.2099990845
170898520014,82,180,262,33.25,84.1100006104,15.8900003433
170898520021,0,0,0,0.0,0.0,0.0
170898520022,130,434,564,55.4599990845,68.6900024414,31.3099994659
170898520023,468,87,555,28.9200000763,14.470000267,85.5299987793
170898520024,742,78,820,34.4099998474,10.8999996185,89.0999984741
170898520031,449,438,887,38.5800018311,74.8700027466,25.1299991608
170898520032,571,613,1184,46.6500015259,63.2599983215,36.7400016785
170898520033,977,358,1335,43.3899993896,32.4199981689,67.5800018311
170898521011,556,222,778,56.0499992371,48.7700004578,51.2299995422
170898521012,1339,895,2234,39.3400001526,44.1800003052,55.8199996948
170898521021,236,485,721,91.5,69.8300018311,30.1700000763
170898521022,409,287,696,53.0499992371,51.3499984741,48.6500015259
170898521023,1299,772,2071,55.9700012207,33.3899993896,66.6100006104
170898521024,393,337,730,41.5699996948,73.9400024414,26.0599994659
170898521025,352,356,708,54.7099990845,51.75,48.25
170898522011,559,502,1061,71.3499984741,36.0999984741,63.9000015259
170898522012,51,328,379,43.6100006104,87.8799972534,12.1199998856
170898522013,5,22,27,2.80999994278,0.0,0.0
170898522014,344,885,1229,87.0400009155,85.6200027466,14.3800001144
170898522021,2316,673,2989,87.7300033569,31.0900001526,68.9100036621
170898522022,690,480,1170,81.25,44.3899993896,55.6100006104
170898522023,2803,176,2979,70.8899993896,9.55000019073,90.4499969482
170898523001,718,164,882,89.4499969482,45.6399993896,54.3600006104
170898523002,802,189,991,96.7799987793,41.7599983215,58.2400016785
170898524011,927,761,1688,51.1800003052,42.8699989319,57.1300010681
170898524012,596,418,1014,51.0800018311,28.9799995422,71.0199966431
170898524013,192,166,358,38.3300018311,46.0600013733,53.9399986267
170898524014,129,95,224,10.2700004578,53.7200012207,46.2799987793
170898524021,1546,373,1919,52.4199981689,36.1899986267,63.8100013733
170898524022,442,301,743,38.6199989319,44.5,55.5
170898524023,1170,246,1416,49.4399986267,17.5400009155,82.4599990845
170898524031,-99998,-99998,-99998,-99998.0,-99998.0,-99998.0
170898524032,-99998,-99998,-99998,-99998.0,-99998.0,-99998.0
170898524033,-99998,-99998,-99998,-99998.0,-99998.0,-99998.0
170898524034,-99998,-99998,-99998,-99998.0,-99998.0,-99998.0
170898524035,-99998,-99998,-99998,-99998.0,-99998.0,-99998.0
170898525001,408,587,995,74.3600006104,32.0600013733,67.9400024414
170898525002,233,167,400,64.8300018311,50.3100013733,49.6899986267
170898525003,439,321,760,76.0800018311,36.0900001526,63.9099998474
170898525004,612,49,661,27.7099990845,12.9499998093,87.0500030518
170898525005,452,327,779,61.7299995422,64.0699996948,35.9300003052
170898526011,520,168,688,65.4599990845,69.3300018311,30.6700000763
170898526012,971,1014,1985,66.9499969482,66.1800003052,33.8199996948
170898526013,433,529,962,66.7600021362,52.6699981689,47.3300018311
170898526014,224,78,302,25.1700000763,40.9500007629,59.0499992371
170898526015,164,413,577,83.1399993896,84.8899993896,15.1099996567
170898526061,674,798,1472,62.8800010681,75.7600021362,24.2399997711
170898526062,808,105,913,37.3600006104,9.18999958038,90.8099975586
170898527001,257,236,493,81.2200012207,52.9399986267,47.0600013733
170898527002,297,354,651,96.8799972534,66.8799972534,33.1199989319
170898527003,613,307,920,81.4899978638,43.1800003052,56.8199996948
170898527004,327,110,437,31.0599994659,26.2600002289,73.7399978638
170898527005,64,248,312,37.9099998474,84.7600021362,15.2399997711
170898527006,169,141,310,11.970000267,59.4199981689,40.5800018311
170898528031,632,605,1237,44.7999992371,68.0999984741,31.8999996185
170898528032,839,335,1174,53.1699981689,37.3899993896,62.6100006104
170898528051,592,235,827,30.3700008392,35.5099983215,64.4899978638
170898528052,462,100,562,55.6399993896,70.9499969482,29.0499992371
170898528053,669,512,1181,57.6399993896,61.0299987793,38.9700012207
170898528061,1639,93,1732,57.7299995422,12.8199996948,87.1800003052
170898528062,88,208,296,34.7799987793,77.5299987793,22.4699993134
170898528063,763,416,1179,40.5900001526,37.1800003052,62.8199996948
170898528071,1086,210,1296,42.5200004578,28.3899993896,71.6100006104
170898528081,858,410,1268,48.1800003052,38.4199981689,61.5800018311
170898528082,15,31,46,2.6400001049,36.0699996948,63.9300003052
170898528083,336,746,1082,69.5800018311,77.3799972534,22.6200008392
170898528084,371,570,941,62.6100006104,73.3600006104,26.6399993896
170898529031,1003,198,1201,87.5999984741,32.6599998474,67.3399963379
170898529032,2132,902,3034,73.6200027466,18.5900001526,81.4100036621
170898529041,961,440,1401,56.5099983215,24.4799995422,75.5199966431
170898529051,678,151,829,94.5299987793,18.4300003052,81.5699996948
170898529052,1001,509,1510,68.0500030518,41.2200012207,58.7799987793
170898529053,860,167,1027,73.8300018311,20.0100002289,79.9899978638
170898529061,690,169,859,46.8400001526,9.03999996185,90.9599990845
170898529062,346,123,469,45.8499984741,30.2800006866,69.7200012207
170898529063,1911,133,2044,82.5199966431,19.0599994659,80.9400024414
170898529071,2276,650,2926,85.3799972534,27.7099990845,72.2900009155
170898529072,500,200,700,46.6399993896,35.2400016785,64.7600021362
170898529073,776,386,1162,75.9000015259,20.5400009155,79.4599990845
170898530011,1617,561,2178,63.6300010681,12.720000267,87.2799987793
170898530041,772,424,1196,75.2200012207,32.0699996948,67.9300003052
170898530042,349,139,488,93.1299972534,34.3199996948,65.6800003052
170898530043,434,92,526,61.3100013733,10.1899995804,89.8099975586
170898530051,260,644,904,32.5900001526,47.9099998474,52.0900001526
170898530052,313,103,416,19.5799999237,34.4500007629,65.5500030518
170898530053,156,0,156,30.4099998474,0.0,100.0
170898530061,287,357,644,45.7700004578,68.2099990845,31.7900009155
170898530062,251,218,469,55.4399986267,66.6600036621,33.3400001526
170898530063,368,353,721,71.4599990845,53.6800003052,46.3199996948
170898530071,727,265,992,80.5800018311,40.5400009155,59.4599990845
170898530072,785,983,1768,64.4499969482,64.0,36.0
170898530073,314,203,517,37.0900001526,52.1100006104,47.8899993896
170898530081,108,0,108,9.64000034332,0.610000014305,99.3899993896
170898530082,773,791,1564,47.6800003052,43.7099990845,56.2900009155
170898531001,69,174,243,16.2800006866,75.6399993896,24.3600006104
170898531002,585,583,1168,77.6100006104,72.9100036621,27.0900001526
170898532001,982,386,1368,98.0599975586,43.5200004578,56.4799995422
170898532002,852,604,1456,60.0400009155,50.0,50.0
170898532003,1055,711,1766,75.3399963379,44.1800003052,55.8199996948
170898533001,134,182,316,18.3099994659,60.1100006104,39.8899993896
170898533002,492,114,606,44.4300003052,10.3199996948,89.6800003052
170898533003,1268,347,1615,75.2600021362,35.0499992371,64.9499969482
170898534001,0,0,0,0.0,0.0,0.0
170898534002,560,41,601,35.6500015259,0.52999997139,99.4700012207
170898534003,728,453,1181,53.2200012207,0.0,0.0
170898534004,361,77,438,20.8999996185,0.0,0.0
170898534005,68,0,68,5.73000001907,0.0,0.0
170898534006,0,0,0,0.0,0.0,0.0
170898535001,474,94,568,39.5,26.9899997711,73.0100021362
170898535002,351,270,621,28.7999992371,45.1699981689,54.8300018311
170898535003,660,171,831,35.7700004578,32.25,67.75
170898535004,929,76,1005,92.2900009155,17.4799995422,82.5199966431
170898536001,1430,106,1536,82.4499969482,26.8099994659,73.1900024414
170898536002,1895,736,2631,90.2300033569,54.4799995422,45.5200004578
170898536003,1734,283,2017,82.8700027466,49.1500015259,50.8499984741
170898536004,1513,141,1654,97.8099975586,42.5600013733,57.4399986267
170898539001,532,299,831,94.6500015259,59.4799995422,40.5200004578
170898539002,234,340,574,76.5299987793,64.7799987793,35.2200012207
170898539003,384,608,992,52.7900009155,71.4899978638,28.5100002289
170898539004,157,289,446,47.5,80.0100021362,19.9899997711
170898539005,416,395,811,58.4300003052,64.3499984741,35.6500015259
170898540011,1103,536,1639,65.4300003052,56.8899993896,43.1100006104
170898540012,507,289,796,72.2300033569,53.6399993896,46.3600006104
170898540013,315,157,472,75.5199966431,41.7799987793,58.2200012207
170898540021,405,46,451,52.8699989319,16.4599990845,83.5400009155
170898540022,176,389,565,69.1600036621,66.4499969482,33.5499992371
170898540023,809,354,1163,68.4100036621,46.3199996948,53.6800003052
170898540024,1022,94,1116,97.1299972534,24.5100002289,75.4899978638
170898540025,516,455,971,69.3099975586,34.3199996948,65.6800003052
170898541001,860,651,1511,94.3799972534,45.3199996948,54.6800003052
170898541002,549,907,1456,94.0,66.6500015259,33.3499984741
170898541003,157,461,618,57.8699989319,80.3399963379,19.6599998474
170898541004,124,356,480,51.5600013733,65.4899978638,34.5099983215
170898542001,816,375,1191,88.8799972534,46.3800010681,53.6199989319
170898542002,197,750,947,63.5999984741,85.5100021362,14.4899997711
170898542003,122,394,516,28.9699993134,79.5500030518,20.4500007629
170898542004,281,254,535,37.3600006104,53.5200004578,46.4799995422
170898543011,589,59,648,55.5699996948,9.27000045776,90.7300033569
170898543012,0,0,0,0.0,0.0,0.0
170898543013,0,0,0,0.0,0.0,0.0
170898543014,965,765,1730,51.3699989319,56.9199981689,43.0800018311
170898543021,313,362,675,40.25,59.0200004578,40.9799995422
170898543022,171,112,283,17.1299991608,22.6200008392,77.3799972534
170898543023,245,436,681,31.1499996185,62.8800010681,37.1199989319
170898544001,337,104,441,60.25,21.6100006104,78.3899993896
170898544002,409,468,877,59.7000007629,51.1800003052,48.8199996948
170898544003,640,370,1010,82.9899978638,19.3099994659,80.6900024414
170898544004,2522,467,2989,45.8899993896,17.1599998474,82.8399963379
170898544005,517,20,537,19.9099998474,4.26000022888,95.7399978638
170898544006,576,760,1336,87.2099990845,50.3600006104,49.6399993896
170898545011,590,331,921,51.1399993896,27.9599990845,72.0400009155
170898545012,1392,211,1603,45.2999992371,18.4699993134,81.5299987793
170898545013,1266,345,1611,44.0299987793,26.0,74.0
170898545014,1127,179,1306,21.1700000763,14.8400001526,85.1600036621
170898545031,754,118,872,52.3400001526,12.6700000763,87.3300018311
170898545032,609,295,904,47.75,18.0,82.0
170898545033,1244,142,1386,53.5800018311,30.0699996948,69.9300003052
170898545034,1967,135,2102,36.7000007629,9.60999965668,90.3899993896
170898545041,447,61,508,29.6399993896,21.1599998474,78.8399963379
170898545042,1605,549,2154,35.9700012207,12.5900001526,87.4100036621
170898546001,988,191,1179,95.0,25.6800003052,74.3199996948
170898546002,1358,284,1642,91.2699966431,27.3799991608,72.6200027466
170898546003,431,102,533,63.0800018311,30.8299999237,69.1699981689
170898547001,559,145,704,81.2900009155,31.0799999237,68.9199981689
170898547002,640,0,640,86.5999984741,12.5500001907,87.4499969482
170898547003,807,68,875,98.9800033569,17.8099994659,82.1900024414
170898548001,574,103,677,33.4500007629,20.6200008392,79.3799972534
170898548002,1016,135,1151,35.2999992371,10.3999996185,89.5999984741
170898548003,852,13,865,34.3499984741,8.09000015259,91.9100036621
170898549001,273,45,318,99.3799972534,50.0499992371,49.9500007629
170898549002,363,107,470,33.4300003052,23.8799991608,76.1200027466
170898549003,1145,269,1414,67.6900024414,25.9400005341,74.0599975586
170898549004,391,564,955,55.0699996948,60.4900016785,39.5099983215
170938901011,5640,371,6011,38.8899993896,10.6300001144,89.3700027466
170938901012,1084,113,1197,46.1300010681,15.8400001526,84.1600036621
170938901021,594,69,663,95.9499969482,38.5,61.5
170938901022,978,239,1217,95.0800018311,48.6599998474,51.3400001526
170938901023,2069,610,2679,58.1300010681,18.3199996948,81.6800003052
170938901024,294,161,455,35.4399986267,45.1599998474,54.8400001526
170938901025,684,320,1004,68.3499984741,29.0900001526,70.9100036621
170938901026,855,284,1139,30.2399997711,12.2700004578,87.7300033569
170938902011,1201,571,1772,78.9000015259,36.7299995422,63.2700004578
170938902012,439,99,538,44.9799995422,11.4399995804,88.5599975586
170938902013,279,106,385,39.6899986267,35.5499992371,64.4499969482
170938902021,365,177,542,56.2799987793,29.1000003815,70.9000015259
170938902022,0,0,0,0.0,0.0,0.0
170938902023,68,9,77,7.67999982834,0.0,0.0
170938903011,654,340,994,28.6000003815,47.25,52.75
170938903012,860,265,1125,40.4399986267,39.6399993896,60.3600006104
170938903021,324,360,684,36.5600013733,68.2900009155,31.7099990845
170938903022,184,112,296,26.3600006104,44.5499992371,55.4500007629
170938903023,49,300,349,20.2900009155,50.4300003052,49.5699996948
170938903024,96,16,112,8.23999977112,15.0100002289,84.9899978638
170938904001,4959,520,5479,35.8499984741,12.1700000763,87.8300018311
170938904002,1591,572,2163,28.0900001526,19.7800006866,80.2200012207
170938904003,918,344,1262,64.9499969482,23.8199996948,76.1800003052
170938904004,681,69,750,57.4700012207,18.2099990845,81.7900009155
170938905001,724,457,1181,83.6399993896,49.8899993896,50.1100006104
170938905002,89,72,161,29.7000007629,2.16000008583,97.8399963379
170938905003,516,7,523,40.4199981689,1.96000003815,98.0400009155
170938905004,-99998,-99998,-99998,-99998.0,-99998.0,-99998.0
170938905005,867,92,959,80.3899993896,12.2700004578,87.7300033569
170938905006,1055,88,1143,18.0699996948,15.720000267,84.2799987793
170938906001,918,119,1037,31.0100002289,14.6300001144,85.3700027466
170938906002,1071,204,1275,38.7400016785,10.6499996185,89.3499984741
170938906003,-99998,-99998,-99998,-99998.0,-99998.0,-99998.0
170938906004,733,117,850,72.3399963379,30.5100002289,69.4899978638
170938907001,1057,56,1113,52.0800018311,6.98000001907,93.0199966431
170938907002,-99998,-99998,-99998,-99998.0,-99998.0,-99998.0
170938907003,-99998,-99998,-99998,-99998.0,-99998.0,-99998.0
170938907004,-99998,-99998,-99998,-99998.0,-99998.0,-99998.0
170938907005,-99998,-99998,-99998,-99998.0,-99998.0,-99998.0
170978601011,2058,405,2463,66.2300033569,35.2200012207,64.7799987793
170978601012,-99998,-99998,-99998,-99998.0,-99998.0,-99998.0
170978601013,-99998,-99998,-99998,-99998.0,-99998.0,-99998.0
170978601031,-99998,-99998,-99998,-99998.0,-99998.0,-99998.0
170978601032,179,187,366,51.9900016785,89.2900009155,10.7100000381
170978601033,-99998,-99998,-99998,-99998.0,-99998.0,-99998.0
170978601041,871,314,1185,60.3699989319,44.8899993896,55.1100006104
170978601042,-99998,-99998,-99998,-99998.0,-99998.0,-99998.0
170978602001,698,56,754,78.3799972534,8.85999965668,91.1399993896
170978602002,898,165,1063,86.1399993896,16.6499996185,83.3499984741
170978602003,614,202,816,64.8099975586,24.5499992371,75.4499969482
170978603011,580,354,934,75.0199966431,42.2200012207,57.7799987793
170978603012,998,279,1277,82.5500030518,32.8499984741,67.1500015259
170978603013,616,204,820,96.3600006104,37.7799987793,62.2200012207
170978603021,344,207,551,62.2599983215,44.2700004578,55.7299995422
170978603022,768,296,1064,79.5199966431,38.2900009155,61.7099990845
170978603023,394,61,455,59.4000015259,20.5100002289,79.4899978638
170978604001,1075,551,1626,53.0,44.5099983215,55.4900016785
170978604002,1097,298,1395,94.8300018311,56.2900009155,43.7099990845
170978604003,814,174,988,60.7599983215,39.2200012207,60.7799987793
170978605001,674,161,835,98.8199996948,33.9300003052,66.0699996948
170978605002,383,324,707,57.8600006104,64.75,35.25
170978605003,151,147,298,57.8600006104,63.8899993896,36.1100006104
170978605004,419,258,677,52.1599998474,49.7999992371,50.2000007629
170978605005,430,85,515,67.3199996948,31.3799991608,68.6200027466
170978606001,680,733,1413,71.8700027466,61.4099998474,38.5900001526
170978606002,129,327,456,30.4200000763,83.6399993896,16.3600006104
170978606003,697,110,807,69.4499969482,32.3300018311,67.6699981689
170978606004,504,245,749,32.2799987793,37.4599990845,62.5400009155
170978608051,-99998,-99998,-99998,-99998.0,-99998.0,-99998.0
170978608052,-99998,-99998,-99998,-99998.0,-99998.0,-99998.0
170978608061,-99998,-99998,-99998,-99998.0,-99998.0,-99998.0
170978608062,-99998,-99998,-99998,-99998.0,-99998.0,-99998.0
170978608071,726,443,1169,52.8699989319,58.3800010681,41.6199989319
170978608072,102,174,276,22.1900005341,81.6299972534,18.3700008392
170978608081,519,276,795,40.5,60.0699996948,39.9300003052
170978608082,99,78,177,23.4099998474,58.0200004578,41.9799995422
170978608091,369,230,599,38.2700004578,45.4799995422,54.5200004578
170978608092,539,241,780,52.4199981689,50.0900001526,49.9099998474
170978608101,-99998,-99998,-99998,-99998.0,-99998.0,-99998.0
170978608102,-99998,-99998,-99998,-99998.0,-99998.0,-99998.0
170978608103,-99998,-99998,-99998,-99998.0,-99998.0,-99998.0
170978608111,843,162,1005,77.25,32.0,68.0
170978608112,736,212,948,33.1899986267,36.7799987793,63.2200012207
170978609031,1620,610,2230,82.7200012207,25.1399993896,74.8600006104
170978609032,701,398,1099,94.0899963379,27.0100002289,72.9899978638
170978609033,349,116,465,32.9599990845,31.3299999237,68.6699981689
170978609034,358,152,510,54.1399993896,47.8800010681,52.1199989319
170978609041,931,110,1041,52.7599983215,19.2900009155,80.7099990845
170978609042,315,309,624,16.8400001526,45.5400009155,54.4599990845
170978609051,1360,622,1982,83.5599975586,52.0,48.0
170978609052,605,299,904,90.5800018311,45.1500015259,54.8499984741
170978609053,560,346,906,65.2300033569,56.6599998474,43.3400001526
170978609054,511,157,668,70.0899963379,48.7400016785,51.2599983215
170978609061,3607,1183,4790,53.6399993896,48.9900016785,51.0099983215
170978610071,1225,335,1560,55.7299995422,37.9500007629,62.0499992371
170978610072,341,521,862,55.8699989319,57.7200012207,42.2799987793
170978610081,125,140,265,17.3500003815,51.8800010681,48.1199989319
170978610082,224,182,406,35.0299987793,32.7099990845,67.2900009155
170978610083,60,152,212,16.6299991608,81.0500030518,18.9500007629
170978610084,490,99,589,46.6300010681,20.4500007629,79.5500030518
170978610091,1035,148,1183,40.2700004578,31.4799995422,68.5199966431
170978610092,864,457,1321,60.7900009155,50.9300003052,49.0699996948
170978610101,172,224,396,42.4000015259,45.8899993896,54.1100006104
170978610102,627,471,1098,79.0500030518,56.9799995422,43.0200004578
170978610103,742,372,1114,32.5499992371,49.0,51.0
170978610111,966,326,1292,55.9500007629,28.9699993134,71.0299987793
170978610112,315,73,388,13.5600004196,23.2000007629,76.8000030518
170978610113,1262,381,1643,56.5200004578,38.75,61.25
170978610121,1488,644,2132,78.0100021362,42.1500015259,57.8499984741
170978610122,523,527,1050,68.3099975586,61.9500007629,38.0499992371
170978610123,152,173,325,39.25,83.8000030518,16.2000007629
170978610131,957,150,1107,35.4399986267,34.1300010681,65.8700027466
170978610141,250,189,439,28.0699996948,53.9399986267,46.0600013733
170978610142,356,213,569,26.5799999237,46.1300010681,53.8699989319
170978611051,484,409,893,53.0600013733,49.4700012207,50.5299987793
170978611052,1181,231,1412,60.0299987793,28.7900009155,71.2099990845
170978611061,733,198,931,41.9000015259,39.0600013733,60.9399986267
170978611062,873,139,1012,34.6699981689,18.1700000763,81.8300018311
170978611063,911,401,1312,41.8600006104,28.3799991608,71.6200027466
170978611071,169,281,450,32.5600013733,91.3199996948,8.68000030518
170978611072,888,806,1694,59.0699996948,34.7200012207,65.2799987793
170978611081,332,282,614,28.3899993896,57.5900001526,42.4099998474
170978611082,770,207,977,55.5099983215,29.7999992371,70.1999969482
170978611083,1430,112,1542,71.4899978638,15.0699996948,84.9300003052
170978612011,1379,480,1859,77.3600006104,31.3500003815,68.6500015259
170978612012,86,158,244,28.9400005341,71.2399978638,28.7600002289
170978612013,932,81,1013,68.2200012207,12.529999733,87.4700012207
170978612014,652,231,883,37.8199996948,28.7399997711,71.2600021362
170978612021,1286,247,1533,70.0299987793,28.8700008392,71.1299972534
170978612022,826,62,888,47.6100006104,0.0,0.0
170978613011,1210,228,1438,61.5099983215,30.0499992371,69.9499969482
170978613012,1329,882,2211,76.4499969482,48.8499984741,51.1500015259
170978613031,1123,50,1173,54.4799995422,10.6300001144,89.3700027466
170978613032,1376,225,1601,56.5699996948,14.7700004578,85.2300033569
170978613041,549,238,787,47.9599990845,28.6200008392,71.3799972534
170978613042,539,192,731,39.5800018311,37.0699996948,62.9300003052
170978614021,1880,313,2193,83.2900009155,40.9399986267,59.0600013733
170978614022,1775,273,2048,33.6699981689,28.7099990845,71.2900009155
170978614031,566,69,635,63.0,27.3700008392,72.6299972534
170978614032,800,447,1247,70.8099975586,47.6100006104,52.3899993896
170978614041,865,775,1640,91.5699996948,60.0999984741,39.9000015259
170978614042,510,274,784,61.1500015259,4.88999986649,95.1100006104
170978614043,1746,324,2070,69.7399978638,23.8400001526,76.1600036621
170978615041,673,34,707,30.3799991608,5.61000013351,94.3899993896
170978615042,1464,170,1634,95.1100006104,29.4400005341,70.5599975586
170978615043,1067,36,1103,57.5099983215,18.6700000763,81.3300018311
170978615044,1562,118,1680,75.5400009155,16.7099990845,83.2900009155
170978615051,1196,201,1397,61.7900009155,25.8899993896,74.1100006104
170978615052,356,266,622,40.2299995422,57.9099998474,42.0900001526
170978615061,873,299,1172,93.6900024414,28.6800003052,71.3199996948
170978615062,366,283,649,21.3799991608,56.4300003052,43.5699996948
170978615063,936,104,1040,94.8899993896,36.0999984741,63.9000015259
170978615071,568,217,785,41.3400001526,8.93000030518,91.0699996948
170978615072,621,81,702,58.1100006104,20.2900009155,79.7099990845
170978615081,560,392,952,35.3800010681,32.5699996948,67.4300003052
170978615082,338,244,582,63.2599983215,52.9399986267,47.0600013733
170978615091,168,323,491,39.5299987793,43.4700012207,56.5299987793
170978615092,1298,546,1844,87.4300003052,31.7299995422,68.2699966431
170978615101,395,89,484,56.4799995422,26.3199996948,73.6800003052
170978615102,474,304,778,55.4900016785,47.0200004578,52.9799995422
170978615103,1360,381,1741,65.6699981689,42.7400016785,57.2599983215
170978616031,1316,185,1501,62.6699981689,22.75,77.25
170978616032,1030,563,1593,56.4099998474,31.6599998474,68.3399963379
170978616033,5,4,9,1.34000003338,0.0,0.0
170978616041,1286,256,1542,49.9500007629,31.2999992371,68.6999969482
170978616042,184,18,202,19.1100006104,10.6599998474,89.3399963379
170978616043,382,271,653,40.8100013733,37.9099998474,62.0900001526
170978616071,199,318,517,29.6800003052,78.9499969482,21.0499992371
170978616072,1023,120,1143,71.9300003052,10.5900001526,89.4100036621
170978616073,272,297,569,50.0,37.0400009155,62.9599990845
170978616081,428,133,561,24.5200004578,33.4700012207,66.5299987793
170978616082,0,0,0,0.0,0.0,0.0
170978616091,662,21,683,26.9099998474,6.26999998093,93.7300033569
170978616092,746,118,864,37.4000015259,21.8799991608,78.1200027466
170978616101,746,77,823,45.1699981689,16.0599994659,83.9400024414
170978616102,602,211,813,47.7700004578,41.7000007629,58.2999992371
170978616111,473,712,1185,79.8499984741,57.8800010681,42.1199989319
170978616112,240,404,644,33.8400001526,59.3400001526,40.6599998474
170978616113,313,56,369,28.9200000763,20.2999992371,79.6999969482
170978617011,537,424,961,81.4400024414,72.5400009155,27.4599990845
170978617012,205,198,403,71.0800018311,64.9400024414,35.0600013733
170978617021,599,230,829,95.5100021362,36.8100013733,63.1899986267
170978617022,582,314,896,38.3699989319,65.4800033569,34.5200004578
170978617023,456,313,769,88.6999969482,55.2400016785,44.7599983215
170978618031,1174,549,1723,74.1999969482,47.5600013733,52.4399986267
170978618032,1138,1131,2269,62.0800018311,58.25,41.75
170978618033,722,71,793,81.3300018311,18.2800006866,81.7200012207
170978618041,820,179,999,45.7799987793,29.8899993896,70.1100006104
170978618042,563,0,563,38.7999992371,1.20000004768,98.8000030518
170978619011,366,233,599,43.6599998474,49.0999984741,50.9000015259
170978619012,254,177,431,49.5999984741,51.5499992371,48.4500007629
170978619013,468,173,641,41.0099983215,29.6800003052,70.3199996948
170978619021,637,158,795,32.4900016785,38.3499984741,61.6500015259
170978619022,195,62,257,32.5299987793,27.9899997711,72.0100021362
170978619023,963,165,1128,49.2599983215,11.4600000381,88.5400009155
170978619024,0,0,0,0.0,0.0,0.0
170978620001,675,128,803,72.5400009155,25.8700008392,74.1299972534
170978620002,746,66,812,64.5500030518,15.1000003815,84.9000015259
170978620003,1050,431,1481,81.5500030518,38.7200012207,61.2799987793
170978620004,1200,62,1262,75.1600036621,21.3199996948,78.6800003052
170978621001,302,149,451,39.5600013733,46.8699989319,53.1300010681
170978621002,938,195,1133,82.2799987793,22.3799991608,77.6200027466
170978621003,304,95,399,49.4399986267,30.3899993896,69.6100006104
170978621004,454,14,468,25.7900009155,26.7600002289,73.2399978638
170978622001,367,618,985,63.4700012207,71.0599975586,28.9400005341
170978622002,1682,533,2215,88.7799987793,43.7099990845,56.2900009155
170978623001,439,91,530,72.0100021362,20.3199996948,79.6800003052
170978623002,967,79,1046,91.4300003052,18.9200000763,81.0800018311
170978623003,912,83,995,93.8700027466,31.6700000763,68.3300018311
170978624011,383,449,832,51.9399986267,0.0,0.0
170978624012,1290,464,1754,82.9300003052,40.6300010681,59.3699989319
170978624021,584,337,921,95.3399963379,55.7099990845,44.2900009155
170978624022,604,222,826,62.9599990845,31.4599990845,68.5400009155
170978624023,746,118,864,80.3000030518,12.1000003815,87.9000015259
170978625011,1621,71,1692,68.6100006104,10.3800001144,89.6200027466
170978625012,1229,170,1399,90.6100006104,31.3700008392,68.6299972534
170978625021,675,78,753,61.7200012207,17.2800006866,82.7200012207
170978625022,595,566,1161,86.3199996948,40.0900001526,59.9099998474
170978626031,759,222,981,94.9700012207,32.7799987793,67.2200012207
170978626032,1241,336,1577,79.4899978638,13.1099996567,86.8899993896
170978626033,641,94,735,61.1500015259,11.8100004196,88.1900024414
170978626034,700,66,766,55.0699996948,6.44000005722,93.5599975586
170978626035,567,150,717,57.9199981689,17.8700008392,82.1299972534
170978626041,1267,357,1624,80.3199996948,43.3400001526,56.6599998474
170978626042,498,0,498,39.9700012207,0.800000011921,99.1999969482
170978626043,1156,40,1196,73.1100006104,8.52000045776,91.4800033569
170978626051,892,1018,1910,100.0,71.1299972534,28.8700008392
170978626052,512,292,804,44.25,28.0599994659,71.9400024414
170978626053,937,1,938,71.8199996948,9.52999973297,90.4700012207
170978627001,296,54,350,47.2999992371,35.9900016785,64.0100021362
170978627002,76,38,114,7.5,0.0,0.0
170978627003,677,127,804,77.4599990845,17.3899993896,82.6100006104
170978627004,309,148,457,43.1100006104,25.5100002289,74.4899978638
170978628001,1106,146,1252,64.9400024414,38.9300003052,61.0699996948
170978629011,1418,22,1440,83.5299987793,3.58999991417,96.4100036621
170978629012,920,56,976,80.5299987793,24.1700000763,75.8300018311
170978629013,760,60,820,100.0,26.6800003052,73.3199996948
170978629021,724,78,802,58.2000007629,38.4000015259,61.5999984741
170978629022,577,220,797,57.6300010681,37.1599998474,62.8400001526
170978630031,2589,143,2732,35.0999984741,7.36000013351,92.6399993896
170978630041,392,250,642,35.6899986267,24.4099998474,75.5899963379
170978630042,1104,351,1455,74.8799972534,24.3199996948,75.6800003052
170978630043,662,138,800,94.5599975586,33.75,66.25
170978630051,1020,1248,2268,50.9799995422,37.2700004578,62.7299995422
170978630061,0,0,0,0.0,0.0,0.0
170978631001,285,36,321,44.3400001526,4.05999994278,95.9400024414
170978631002,972,71,1043,60.1500015259,15.9899997711,84.0100021362
170978632011,710,126,836,95.8700027466,25.1700000763,74.8300018311
170978632012,541,106,647,68.7600021362,17.4300003052,82.5699996948
170978632013,1089,385,1474,89.3899993896,35.6899986267,64.3099975586
170978632021,401,595,996,76.9700012207,37.1899986267,62.8100013733
170978632022,451,243,694,73.1299972534,43.1399993896,56.8600006104
170978632023,524,770,1294,84.9599990845,55.5600013733,44.4399986267
170978632024,216,668,884,68.2600021362,94.4199981689,5.57999992371
170978633001,208,399,607,72.3499984741,80.8000030518,19.2000007629
170978633002,101,309,410,52.9000015259,85.9000015259,14.1000003815
170978633003,251,673,924,82.8000030518,88.1999969482,11.8000001907
170978634001,53,165,218,26.4599990845,60.8499984741,39.1500015259
170978634002,352,1268,1620,70.4700012207,94.9199981689,5.07999992371
170978634003,289,840,1129,98.8600006104,88.5500030518,11.4499998093
170978635001,173,1052,1225,100.0,94.7799987793,5.21999979019
170978635002,192,617,809,72.4300003052,90.0,10.0
170978635003,427,786,1213,63.5699996948,74.7600021362,25.2399997711
170978636011,754,534,1288,54.3899993896,44.7799987793,55.2200012207
170978636012,523,228,751,62.4799995422,31.6000003815,68.4000015259
170978636031,617,631,1248,51.5900001526,46.2999992371,53.7000007629
170978636032,371,67,438,35.2099990845,15.0399999619,84.9599990845
170978636041,596,404,1000,56.6300010681,59.7999992371,40.2000007629
170978636042,496,380,876,74.9400024414,60.2900009155,39.7099990845
170978637011,544,515,1059,56.0,65.4899978638,34.5099983215
170978637012,589,282,871,76.8799972534,48.9199981689,51.0800018311
170978637013,838,134,972,66.3899993896,30.6499996185,69.3499984741
170978637021,812,595,1407,79.7200012207,30.7900009155,69.2099990845
170978637022,831,323,1154,58.6100006104,34.7900009155,65.2099990845
170978638011,674,314,988,43.5800018311,71.1999969482,28.7999992371
170978638012,892,177,1069,44.7099990845,24.8400001526,75.1600036621
170978639021,158,135,293,15.3599996567,42.3600006104,57.6399993896
170978639022,145,50,195,18.0699996948,0.0,0.0
170978639023,522,245,767,64.8899993896,37.2299995422,62.7700004578
170978639024,149,96,245,18.1100006104,0.0,0.0
170978639031,396,208,604,63.7799987793,50.4399986267,49.5600013733
170978639032,644,406,1050,65.3799972534,53.7099990845,46.2900009155
170978639033,119,95,214,21.25,46.3400001526,53.6599998474
170978639034,142,259,401,47.1199989319,72.7399978638,27.2600002289
170978639041,1430,92,1522,37.3499984741,6.09000015259,93.9100036621
170978639042,187,87,274,14.0699996948,31.5100002289,68.4899978638
170978640011,603,345,948,53.9599990845,41.6699981689,58.3300018311
170978640012,183,92,275,12.0,55.75,44.25
170978640013,1359,526,1885,82.2799987793,55.4900016785,44.5099983215
170978640021,288,240,528,49.2099990845,34.9199981689,65.0800018311
170978640022,1113,381,1494,91.6600036621,36.0600013733,63.9399986267
170978640023,497,646,1143,65.4300003052,61.5699996948,38.4300003052
170978640024,697,220,917,50.1899986267,15.3999996185,84.5999984741
170978641011,640,115,755,27.7999992371,18.4200000763,81.5800018311
170978641012,2783,358,3141,46.0800018311,35.7000007629,64.3000030518
170978641013,870,355,1225,64.3399963379,54.9399986267,45.0600013733
170978641051,1890,243,2133,57.0299987793,22.1100006104,77.8899993896
170978641052,1202,468,1670,72.0800018311,25.6100006104,74.3899993896
170978641061,132,337,469,40.2200012207,34.8400001526,65.1600036621
170978641062,180,142,322,60.8699989319,32.5400009155,67.4599990845
170978641063,1123,434,1557,100.0,45.9000015259,54.0999984741
170978641064,348,444,792,99.1200027466,72.2200012207,27.7800006866
170978641071,1333,582,1915,83.5199966431,37.4300003052,62.5699996948
170978641072,669,1038,1707,64.25,54.3100013733,45.6899986267
170978641081,666,580,1246,46.8199996948,42.8100013733,57.1899986267
170978641082,959,328,1287,71.2600021362,36.9500007629,63.0499992371
170978641083,388,443,831,66.8000030518,80.9199981689,19.0799999237
170978642031,383,327,710,43.6699981689,56.9099998474,43.0900001526
170978642032,1055,405,1460,53.9300003052,26.9699993134,73.0299987793
170978642041,996,487,1483,82.8499984741,34.5800018311,65.4199981689
170978642042,683,325,1008,72.0500030518,54.0800018311,45.9199981689
170978642043,513,168,681,42.4300003052,53.1300010681,46.8699989319
170978642051,2927,460,3387,65.0,17.6399993896,82.3600006104
170978642052,805,438,1243,73.6800003052,41.3800010681,58.6199989319
170978642053,594,497,1091,49.6599998474,57.8800010681,42.1199989319
170978642061,1569,483,2052,87.0999984741,44.4799995422,55.5200004578
170978642062,511,467,978,85.3399963379,67.2300033569,32.7700004578
170978643031,296,664,960,65.4400024414,76.1999969482,23.7999992371
170978643032,144,184,328,21.8500003815,69.5699996948,30.4300003052
170978643033,273,417,690,44.9799995422,66.8099975586,33.1899986267
170978643051,225,582,807,35.6899986267,90.6999969482,9.30000019073
170978643052,193,651,844,53.4500007629,77.1900024414,22.8099994659
170978643061,217,183,400,35.2099990845,79.6299972534,20.3700008392
170978643062,121,312,433,38.3199996948,94.8899993896,5.11000013351
170978643071,567,570,1137,60.8300018311,73.2900009155,26.7099990845
170978643081,420,730,1150,78.0699996948,80.3099975586,19.6900005341
170978643082,727,295,1022,97.3300018311,48.2799987793,51.7200012207
170978643083,700,585,1285,71.0699996948,64.6600036621,35.3400001526
170978644021,612,508,1120,32.3100013733,66.4300003052,33.5699996948
170978644022,333,437,770,38.2700004578,55.5299987793,44.4700012207
170978644023,290,426,716,39.8899993896,65.2900009155,34.7099990845
170978644031,561,294,855,52.9099998474,70.3700027466,29.6299991608
170978644032,495,547,1042,52.1500015259,76.9100036621,23.0900001526
170978644033,460,362,822,52.0900001526,41.7799987793,58.2200012207
170978644071,957,769,1726,59.0499992371,52.1199989319,47.8800010681
170978644072,1108,650,1758,63.9700012207,51.0900001526,48.9099998474
170978644081,693,595,1288,69.6999969482,46.4099998474,53.5900001526
170978644082,479,521,1000,47.5999984741,57.5699996948,42.4300003052
170978644083,945,277,1222,66.5899963379,35.6699981689,64.3300018311
170978644091,213,242,455,49.0299987793,60.9300003052,39.0699996948
170978644092,1883,236,2119,85.0999984741,28.7600002289,71.2399978638
170978644093,144,269,413,33.6300010681,72.9000015259,27.1000003815
170978644101,446,212,658,35.1100006104,23.1700000763,76.8300018311
170978644102,775,328,1103,41.1300010681,33.7299995422,66.2699966431
170978644103,190,250,440,68.3199996948,74.0800018311,25.9200000763
170978644111,514,275,789,64.25,60.5,39.5
170978644112,820,199,1019,52.7200012207,38.7700004578,61.2299995422
170978644113,373,487,860,49.0299987793,72.0100021362,27.9899997711
170978644121,764,331,1095,58.2799987793,50.9099998474,49.0900001526
170978644122,443,578,1021,45.1399993896,75.7600021362,24.2399997711
170978645051,259,415,674,61.6699981689,91.3899993896,8.60999965668
170978645052,180,31,211,12.9799995422,9.23999977112,90.7600021362
170978645053,507,141,648,31.0599994659,21.7600002289,78.2399978638
170978645054,699,584,1283,75.3399963379,50.3600006104,49.6399993896
170978645101,755,874,1629,73.3799972534,25.9099998474,74.0899963379
170978645102,1583,211,1794,92.2399978638,30.4599990845,69.5400009155
170978645111,500,245,745,52.6100006104,41.9000015259,58.0999984741
170978645112,229,673,902,30.7600002289,62.0099983215,37.9900016785
170978645113,145,113,258,33.8600006104,64.6399993896,35.3600006104
170978645114,130,404,534,35.9599990845,78.9300003052,21.0699996948
170978645121,1031,489,1520,65.0699996948,35.9099998474,64.0899963379
170978645122,85,132,217,9.76000022888,75.8399963379,24.1599998474
170978645131,248,206,454,25.3600006104,26.1900005341,73.8099975586
170978645132,234,33,267,21.9200000763,9.96000003815,90.0400009155
170978645133,0,0,0,0.0,0.0,0.0
170978645134,187,120,307,28.9099998474,71.0100021362,28.9899997711
170978645141,1376,654,2030,81.6200027466,45.8400001526,54.1599998474
170978645151,388,438,826,42.3600006104,67.6100006104,32.3899993896
170978645152,211,451,662,68.1100006104,74.8899993896,25.1100006104
170978645161,262,421,683,59.7000007629,73.3499984741,26.6499996185
170978645162,170,354,524,41.1899986267,75.3600006104,24.6399993896
170978645163,884,681,1565,73.2699966431,57.4500007629,42.5499992371
170978645171,617,384,1001,57.9300003052,40.6800003052,59.3199996948
170978645172,436,537,973,82.1800003052,68.1399993896,31.8600006104
170978645181,738,392,1130,67.5,37.2200012207,62.7799987793
170978645182,673,372,1045,60.7599983215,46.7700004578,53.2299995422
170978645183,147,45,192,23.1299991608,29.8999996185,70.0999984741
170978645184,687,236,923,72.0500030518,31.9200000763,68.0800018311
170978645191,1134,907,2041,88.3199996948,39.0999984741,60.9000015259
170978645192,850,821,1671,64.9199981689,53.7900009155,46.2099990845
170978645201,1421,360,1781,82.5699996948,30.9599990845,69.0400009155
170978645202,324,258,582,39.4300003052,28.5300006866,71.4700012207
170978645203,596,361,957,58.2099990845,35.1199989319,64.8799972534
170978645211,1485,269,1754,69.9400024414,30.8500003815,69.1500015259
170978645221,377,656,1033,56.0800018311,78.6600036621,21.3400001526
170978645222,270,568,838,60.1599998474,91.2399978638,8.76000022888
170978645223,187,445,632,43.3499984741,93.5899963379,6.40999984741
170978646011,238,370,608,55.4199981689,82.1699981689,17.8299999237
170978646012,754,1112,1866,71.1100006104,74.1100006104,25.8899993896
170978646021,868,820,1688,77.4700012207,72.4000015259,27.6000003815
170978646022,422,865,1287,72.75,95.1500015259,4.84999990463
170978647001,130,308,438,47.7099990845,98.5599975586,1.44000005722
170978647002,176,637,813,97.1299972534,97.2699966431,2.73000001907
170978647003,321,550,871,68.3099975586,71.3799972534,28.6200008392
170978648011,1275,307,1582,86.7300033569,51.2900009155,48.7099990845
170978648012,317,109,426,42.4300003052,0.0,0.0
170978648013,94,408,502,29.9699993134,94.2099990845,5.78999996185
170978648014,229,538,767,75.1200027466,83.9800033569,16.0200004578
170978648021,1033,1367,2400,89.3199996948,55.1599998474,44.8400001526
170978649011,254,859,1113,42.5900001526,56.6699981689,43.3300018311
170978649012,471,600,1071,63.9799995422,58.0499992371,41.9500007629
170978649031,450,532,982,43.4900016785,40.8899993896,59.1100006104
170978649032,404,605,1009,77.4400024414,73.8199996948,26.1800003052
170978649033,285,416,701,55.5499992371,66.3000030518,33.7000007629
170978649041,1176,608,1784,74.1200027466,48.8899993896,51.1100006104
170978650001,83,627,710,52.75,96.0999984741,3.90000009537
170978652001,623,144,767,73.75,0.0,100.0
170978652002,674,133,807,91.0800018311,43.1500015259,56.8499984741
170978652003,673,291,964,66.7099990845,47.4000015259,52.5999984741
170978652004,1476,279,1755,76.9100036621,20.6599998474,79.3399963379
170978653001,420,287,707,40.4500007629,79.0,21.0
170978653002,37,151,188,27.6499996185,86.9599990845,13.0399999619
170978653003,426,245,671,73.3300018311,67.5800018311,32.4199981689
170978654001,501,406,907,97.8399963379,42.6699981689,57.3300018311
170978654002,836,145,981,98.0999984741,36.0600013733,63.9399986267
170978654003,624,691,1315,56.8300018311,51.3400001526,48.6599998474
170978655011,418,191,609,42.4700012207,53.7700004578,46.2299995422
170978655012,0,20,20,2.16000008583,37.9799995422,62.0200004578
170978655021,654,46,700,74.7900009155,27.6499996185,72.3499984741
170978655022,157,551,708,47.9700012207,88.4700012207,11.529999733
170978656001,35,284,319,44.5499992371,98.1299972534,1.87000000477
170978656002,55,441,496,71.9899978638,99.0599975586,0.939999997616
170978656003,0,208,208,21.8500003815,0.0,0.0
170978656004,187,842,1029,88.7799987793,97.3600006104,2.6400001049
170978657001,338,1154,1492,92.7300033569,92.9700012207,7.03000020981
170978657002,237,964,1201,95.1699981689,92.1500015259,7.84999990463
170978657003,491,1540,2031,69.7900009155,92.5,7.5
170978658011,267,551,818,92.5299987793,91.5500030518,8.44999980927
170978658012,971,462,1433,98.9000015259,49.1899986267,50.8100013733
170978658013,187,473,660,92.5699996948,89.1900024414,10.8100004196
170978658021,136,284,420,68.6299972534,89.1200027466,10.8800001144
170978658022,427,970,1397,57.7799987793,75.4400024414,24.5599994659
170978660001,-99998,-99998,-99998,-99998.0,-99998.0,-99998.0
170978660002,-99998,-99998,-99998,-99998.0,-99998.0,-99998.0
170978660003,265,134,399,32.8899993896,44.8400001526,55.1599998474
170978661001,1507,270,1777,92.0699996948,27.2299995422,72.7699966431
170978661002,917,335,1252,75.9199981689,44.6899986267,55.3100013733
170978662001,1530,988,2518,70.4700012207,55.2900009155,44.7099990845
170978662002,267,204,471,58.5099983215,42.8800010681,57.1199989319
170978662003,567,291,858,58.1300010681,41.75,58.25
171118701011,-99998,-99998,-99998,-99998.0,-99998.0,-99998.0
171118701012,-99998,-99998,-99998,-99998.0,-99998.0,-99998.0
171118701013,-99998,-99998,-99998,-99998.0,-99998.0,-99998.0
171118701014,-99998,-99998,-99998,-99998.0,-99998.0,-99998.0
171118701021,-99998,-99998,-99998,-99998.0,-99998.0,-99998.0
171118701022,-99998,-99998,-99998,-99998.0,-99998.0,-99998.0
171118701023,680,314,994,47.4000015259,51.3400001526,48.6599998474
171118702001,1684,83,1767,76.1999969482,27.7800006866,72.2200012207
171118702002,-99998,-99998,-99998,-99998.0,-99998.0,-99998.0
171118702003,875,97,972,68.3499984741,23.3899993896,76.6100006104
171118702004,-99998,-99998,-99998,-99998.0,-99998.0,-99998.0
171118703011,-99998,-99998,-99998,-99998.0,-99998.0,-99998.0
171118703012,-99998,-99998,-99998,-99998.0,-99998.0,-99998.0
171118703013,623,238,861,64.5400009155,45.6199989319,54.3800010681
171118703021,825,342,1167,77.5899963379,41.0400009155,58.9599990845
171118703022,-99998,-99998,-99998,-99998.0,-99998.0,-99998.0
171118703023,1066,114,1180,75.7399978638,14.6400003433,85.3600006104
171118704011,666,377,1043,28.9699993134,44.2599983215,55.7400016785
171118704012,518,324,842,44.6399993896,38.0699996948,61.9300003052
171118704013,538,464,1002,38.5699996948,65.0,35.0
171118704021,968,696,1664,43.1399993896,29.7700004578,70.2300033569
171118704022,394,412,806,38.6899986267,55.5299987793,44.4700012207
171118705001,692,246,938,35.7200012207,48.9399986267,51.0600013733
171118705002,190,122,312,22.1599998474,45.5600013733,54.4399986267
171118705003,575,432,1007,53.0600013733,34.3300018311,65.6699981689
171118705004,349,364,713,87.0599975586,56.2799987793,43.7200012207
171118705005,326,613,939,73.8199996948,77.2799987793,22.7199993134
171118705006,286,293,579,96.5,70.6900024414,29.3099994659
171118705007,16,16,32,4.80000019073,44.7799987793,55.2200012207
171118706031,807,490,1297,51.2400016785,29.9200000763,70.0800018311
171118706032,628,79,707,33.6699981689,9.22000026703,90.7799987793
171118706041,160,70,230,13.4600000381,54.5200004578,45.4799995422
171118706042,1456,232,1688,62.7299995422,22.9799995422,77.0199966431
171118706043,618,101,719,44.8800010681,13.3500003815,86.6500015259
171118706051,806,710,1516,46.5600013733,59.0200004578,40.9799995422
171118706052,1314,170,1484,46.9900016785,22.8999996185,77.0999984741
171118706061,922,183,1105,92.3899993896,24.9899997711,75.0100021362
171118706062,1124,571,1695,98.3700027466,42.2799987793,57.7200012207
171118706063,374,146,520,42.6599998474,56.4799995422,43.5200004578
171118707021,245,223,468,28.7800006866,59.5900001526,40.4099998474
171118707022,648,351,999,42.3499984741,49.3499984741,50.6500015259
171118707023,644,381,1025,78.8499984741,35.3899993896,64.6100006104
171118707024,894,359,1253,51.8400001526,31.8899993896,68.1100006104
171118707031,413,106,519,79.4800033569,39.1500015259,60.8499984741
171118707032,1004,457,1461,49.4099998474,26.6399993896,73.3600006104
171118707033,780,361,1141,56.5699996948,35.8800010681,64.1200027466
171118707041,286,311,597,75.6699981689,63.4000015259,36.5999984741
171118707042,438,320,758,67.4400024414,47.4799995422,52.5200004578
171118707043,335,402,737,62.7200012207,63.9199981689,36.0800018311
171118707044,37,104,141,18.4599990845,84.5299987793,15.470000267
171118708031,568,358,926,47.1699981689,52.2099990845,47.7900009155
171118708032,339,522,861,46.8199996948,70.8600006104,29.1399993896
171118708033,379,354,733,43.7599983215,58.8600006104,41.1399993896
171118708034,959,296,1255,47.0699996948,28.5799999237,71.4199981689
171118708071,907,544,1451,72.0500030518,39.7999992371,60.2000007629
171118708072,758,883,1641,47.8400001526,65.3799972534,34.6199989319
171118708081,673,877,1550,68.7399978638,64.5899963379,35.4099998474
171118708082,656,559,1215,80.3600006104,46.2599983215,53.7400016785
171118708091,1041,525,1566,45.8199996948,24.5799999237,75.4199981689
171118708092,913,1093,2006,57.6800003052,58.8300018311,41.1699981689
171118708101,32,6,38,4.86000013351,48.0999984741,51.9000015259
171118708102,402,408,810,37.4799995422,48.9599990845,51.0400009155
171118708103,84,333,417,26.4099998474,50.7099990845,49.2900009155
171118708111,721,544,1265,62.2799987793,58.7400016785,41.2599983215
171118708112,461,177,638,50.2400016785,60.5400009155,39.4599990845
171118708113,644,267,911,68.5500030518,41.8499984741,58.1500015259
171118708121,326,451,777,66.9300003052,53.5600013733,46.4399986267
171118708122,106,116,222,26.0599994659,69.7300033569,30.2700004578
171118708123,628,123,751,60.9599990845,45.3699989319,54.6300010681
171118708124,80,262,342,20.7700004578,51.3199996948,48.6800003052
171118709021,523,514,1037,58.0999984741,38.8499984741,61.1500015259
171118709022,434,323,757,25.8899993896,67.1900024414,32.8100013733
171118709023,1207,97,1304,44.7999992371,21.1599998474,78.8399963379
171118709031,1193,397,1590,94.6399993896,41.8800010681,58.1199989319
171118709032,148,135,283,35.8199996948,47.4700012207,52.5299987793
171118709033,569,256,825,75.3399963379,37.7599983215,62.2400016785
171118709041,387,181,568,95.7799987793,59.7099990845,40.2900009155
171118709042,1195,734,1929,82.4000015259,43.1599998474,56.8400001526
171118709043,607,708,1315,68.2099990845,62.2000007629,37.7999992371
171118709051,1872,308,2180,100.0,25.3199996948,74.6800003052
171118709052,978,467,1445,53.5800018311,17.9799995422,82.0199966431
171118710031,-99998,-99998,-99998,-99998.0,-99998.0,-99998.0
171118710032,430,275,705,72.0899963379,30.8400001526,69.1600036621
171118710033,901,652,1553,61.0499992371,38.0200004578,61.9799995422
171118710041,1216,682,1898,63.0400009155,42.7299995422,57.2700004578
171118710042,730,358,1088,53.3600006104,35.7400016785,64.2600021362
171118710043,-99998,-99998,-99998,-99998.0,-99998.0,-99998.0
171118711041,3723,551,4274,37.0600013733,13.5100002289,86.4899978638
171118711042,793,236,1029,61.0299987793,25.2399997711,74.7600021362
171118711043,936,143,1079,82.6200027466,19.1599998474,80.8399963379
171118711044,826,216,1042,34.7099990845,19.7399997711,80.2600021362
171118711051,881,438,1319,43.7000007629,38.7099990845,61.2900009155
171118711052,211,459,670,48.7999992371,84.7699966431,15.2299995422
171118711053,195,289,484,57.6899986267,74.3899993896,25.6100006104
171118711061,1426,228,1654,28.8899993896,22.1499996185,77.8499984741
171118711062,621,306,927,49.4900016785,44.4500007629,55.5499992371
171118711063,243,503,746,47.9700012207,80.3700027466,19.6299991608
171118711071,1193,315,1508,64.75,28.4300003052,71.5699996948
171118711072,805,215,1020,34.7799987793,19.7600002289,80.2399978638
171118711081,1230,895,2125,60.3199996948,43.3600006104,56.6399993896
171118711082,118,26,144,6.48999977112,35.5800018311,64.4199981689
171118711091,568,27,595,17.8700008392,5.5,94.5
171118711092,657,72,729,39.4099998474,9.89999961853,90.0999984741
171118712011,636,479,1115,81.8600006104,73.3700027466,26.6299991608
171118712012,148,305,453,22.0499992371,62.7000007629,37.2999992371
171118712013,315,142,457,75.7900009155,50.7799987793,49.2200012207
171118712014,788,327,1115,40.6199989319,22.2199993134,77.7799987793
171118712021,520,851,1371,78.3399963379,67.8099975586,32.1899986267
171118712022,541,519,1060,65.8399963379,48.4900016785,51.5099983215
171118712023,627,29,656,48.4500007629,10.8199996948,89.1800003052
171118712024,262,6,268,23.7199993134,0.0,0.0
171118712051,616,346,962,53.3300018311,43.6699981689,56.3300018311
171118712052,244,396,640,34.5800018311,63.2299995422,36.7700004578
171118712053,0,0,0,0.0,0.0,0.0
171118712061,532,276,808,52.7400016785,27.6299991608,72.3700027466
171118712062,1031,115,1146,33.9000015259,9.53999996185,90.4599990845
171118712063,408,316,724,40.1800003052,36.8300018311,63.1699981689
171118712071,680,307,987,45.1500015259,27.1399993896,72.8600006104
171118712072,389,254,643,55.9099998474,23.7399997711,76.2600021362
171118712073,435,368,803,63.0299987793,67.6500015259,32.3499984741
171118712081,307,322,629,30.7099990845,71.2699966431,28.7299995422
171118712082,224,111,335,17.8500003815,7.34000015259,92.6600036621
171118712091,1436,363,1799,67.4300003052,17.25,82.75
171118712092,551,0,551,69.5699996948,0.0,100.0
171118713011,558,611,1169,98.2399978638,68.7600021362,31.2399997711
171118713012,298,368,666,93.4100036621,58.9000015259,41.0999984741
171118713013,677,254,931,72.6800003052,26.2600002289,73.7399978638
171118713014,451,381,832,58.0200004578,36.2099990845,63.7900009155
171118713041,650,529,1179,46.5999984741,39.7400016785,60.2599983215
171118713042,252,321,573,80.6999969482,70.2099990845,29.7900009155
171118713051,1196,514,1710,49.2900009155,59.4000015259,40.5999984741
171118713052,769,366,1135,68.6200027466,43.9599990845,56.0400009155
171118713053,611,676,1287,82.3399963379,67.0500030518,32.9500007629
171118713061,283,0,283,11.6300001144,9.92000007629,90.0800018311
171118713062,277,192,469,25.5900001526,61.9599990845,38.0400009155
171118713063,425,486,911,37.5699996948,39.3300018311,60.6699981689
171118713064,809,209,1018,58.8400001526,17.7399997711,82.2600021362
171118713071,185,410,595,29.8999996185,63.5699996948,36.4300003052
171118713072,12,12,24,3.68000006676,57.1500015259,42.8499984741
171118713073,913,573,1486,67.6399993896,50.5099983215,49.4900016785
171118713101,167,734,901,64.0400009155,92.3199996948,7.67999982834
171118713102,35,33,68,9.60000038147,43.7799987793,56.2200012207
171118713103,424,223,647,97.5899963379,53.3199996948,46.6800003052
171118713104,88,228,316,19.6800003052,86.4899978638,13.5100002289
171118713111,1029,731,1760,74.0699996948,36.3100013733,63.6899986267
171118713112,457,411,868,85.4300003052,56.3100013733,43.6899986267
171118713113,366,210,576,53.9300003052,33.6800003052,66.3199996948
171118714021,612,44,656,44.6300010681,22.8299999237,77.1699981689
171118714022,240,348,588,68.8499984741,65.9300003052,34.0699996948
171118714023,414,664,1078,49.4300003052,48.5,51.5
171118714024,104,189,293,33.3300018311,78.1699981689,21.8299999237
171118714025,194,329,523,60.0499992371,82.8499984741,17.1499996185
171118714041,697,396,1093,46.8499984741,43.7000007629,56.2999992371
171118714042,570,489,1059,48.3300018311,41.0299987793,58.9700012207
171118715001,-99998,-99998,-99998,-99998.0,-99998.0,-99998.0
171118715002,475,162,637,71.5699996948,17.0799999237,82.9199981689
171118715003,658,150,808,15.8100004196,18.9799995422,81.0199966431
171118715004,730,203,933,62.9099998474,36.2299995422,63.7700004578
171118715005,284,86,370,26.8299999237,24.0699996948,75.9300003052
171118716001,56,93,149,16.3199996948,77.6900024414,22.3099994659
171118716002,196,26,222,18.4200000763,13.4499998093,86.5500030518
171118716003,155,313,468,59.1699981689,88.6399993896,11.3599996567
171118716004,259,351,610,60.7599983215,84.6100006104,15.3900003433
171118716005,513,206,719,71.1900024414,20.0900001526,79.9100036621
171978801051,847,236,1083,56.0,32.6300010681,67.3700027466
171978801052,369,367,736,33.2099990845,44.6199989319,55.3800010681
171978801053,442,356,798,49.2599983215,48.7000007629,51.2999992371
171978801054,415,324,739,34.3899993896,41.5299987793,58.4700012207
171978801061,597,424,1021,73.8300018311,42.6599998474,57.3400001526
171978801062,169,392,561,50.5900001526,80.3399963379,19.6599998474
171978801063,457,679,1136,56.7700004578,63.7099990845,36.2900009155
171978801071,656,496,1152,77.5199966431,52.5800018311,47.4199981689
171978801072,461,235,696,52.1699981689,28.3600006104,71.6399993896
171978801073,405,572,977,71.0,61.4000015259,38.5999984741
171978801074,242,133,375,42.3300018311,37.0699996948,62.9300003052
171978801091,42,400,442,45.7999992371,100.0,0.0
171978801092,124,274,398,34.3100013733,74.9199981689,25.0799999237
171978801093,297,214,511,52.2999992371,21.6399993896,78.3600006104
171978801094,426,985,1411,93.4400024414,64.5599975586,35.4399986267
171978801095,149,130,279,33.0999984741,59.3699989319,40.6300010681
171978801111,356,9,365,25.5799999237,20.7900009155,79.2099990845
171978801112,0,0,0,0.0,0.0,0.0
171978801113,0,0,0,0.0,0.0,0.0
171978801121,791,0,791,71.9700012207,0.0,100.0
171978801122,280,0,280,28.0799999237,0.0,0.0
171978801131,612,327,939,64.4899978638,12.7899999619,87.2099990845
171978801132,740,23,763,59.6599998474,5.48000001907,94.5199966431
171978801133,129,916,1045,97.1200027466,88.6999969482,11.3000001907
171978801141,1162,339,1501,67.7699966431,11.9200000763,88.0800018311
171978801142,529,257,786,91.7200012207,50.8199996948,49.1800003052
171978801151,874,798,1672,69.4100036621,36.9300003052,63.0699996948
171978801152,212,343,555,73.6100006104,56.6500015259,43.3499984741
171978801161,99,6,105,6.48999977112,0.0,0.0
171978801162,579,360,939,71.3000030518,35.3600006104,64.6399993896
171978801171,403,23,426,38.2099990845,1.49000000954,98.5100021362
171978801172,88,27,115,9.67000007629,0.0,0.0
171978801173,288,10,298,29.2199993134,0.0,100.0
171978801181,220,477,697,52.2099990845,89.1299972534,10.8699998856
171978801182,407,564,971,95.2900009155,71.5199966431,28.4799995422
171978801183,224,445,669,54.6100006104,67.75,32.25
171978801184,199,110,309,26.8899993896,51.1800003052,48.8199996948
171978801191,274,514,788,56.6500015259,74.4400024414,25.5599994659
171978801192,147,132,279,19.0100002289,51.6500015259,48.3499984741
171978801193,334,601,935,63.6899986267,69.3300018311,30.6700000763
171978801201,1548,1188,2736,72.0899963379,42.8899993896,57.1100006104
171978801202,1134,617,1751,38.7799987793,27.3899993896,72.6100006104
171978801203,415,154,569,36.4000015259,13.2899999619,86.7099990845
171978801211,789,179,968,72.0199966431,5.01000022888,94.9899978638
171978801212,408,130,538,33.8199996948,13.6999998093,86.3000030518
171978801213,754,204,958,24.1000003815,12.3599996567,87.6399993896
171978801214,1147,116,1263,49.8600006104,16.8199996948,83.1800003052
171978802021,222,219,441,70.0,18.2999992371,81.6999969482
171978802022,189,80,269,16.3500003815,3.19000005722,96.8099975586
171978802023,1534,334,1868,89.0800018311,15.1800003052,84.8199996948
171978802031,527,170,697,55.1899986267,17.0200004578,82.9800033569
171978802032,421,26,447,24.3199996948,28.1299991608,71.8700027466
171978802033,119,90,209,25.7700004578,20.2600002289,79.7399978638
171978802041,445,39,484,56.1500015259,24.5900001526,75.4100036621
171978802042,1985,153,2138,53.2000007629,8.44999980927,91.5500030518
171978802043,173,147,320,28.6000003815,7.61999988556,92.3799972534
171978803031,217,143,360,24.3099994659,44.5600013733,55.4399986267
171978803032,332,346,678,49.3400001526,61.7299995422,38.2700004578
171978803033,573,240,813,64.6800003052,37.2400016785,62.7599983215
171978803041,175,183,358,25.6299991608,59.0499992371,40.9500007629
171978803042,0,0,0,0.0,0.0,0.0
171978803043,280,206,486,38.1199989319,58.5200004578,41.4799995422
171978803044,537,203,740,53.8199996948,55.5499992371,44.4500007629
171978803051,36,189,225,21.4899997711,72.1399993896,27.8600006104
171978803052,450,713,1163,73.0500030518,63.0499992371,36.9500007629
171978803053,421,339,760,73.5,47.5800018311,52.4199981689
171978803054,224,370,594,31.3099994659,61.5,38.5
171978803061,915,565,1480,70.2399978638,34.0999984741,65.9000015259
171978803062,580,633,1213,40.1800003052,34.5600013733,65.4400024414
171978803063,1129,427,1556,57.0,31.7299995422,68.2699966431
171978803071,354,226,580,45.6300010681,46.3800010681,53.6199989319
171978803072,669,195,864,45.2400016785,15.5699996948,84.4300003052
171978803073,1346,28,1374,47.8899993896,3.19000005722,96.8099975586
171978803081,302,320,622,29.0100002289,16.9300003052,83.0699996948
171978803082,2634,265,2899,65.5599975586,18.25,81.75
171978803083,503,204,707,48.0999984741,29.7700004578,70.2300033569
171978803091,349,313,662,43.9599990845,36.0200004578,63.9799995422
171978803092,384,350,734,67.5899963379,24.7600002289,75.2399978638
171978803093,471,217,688,58.75,36.4599990845,63.5400009155
171978803094,495,735,1230,77.5999984741,67.0,33.0
171978803101,4544,994,5538,48.2000007629,12.2100000381,87.7900009155
171978803121,2280,1105,3385,50.1899986267,20.5100002289,79.4899978638
171978803122,553,266,819,33.6800003052,27.4699993134,72.5299987793
171978803131,930,481,1411,27.7999992371,34.3800010681,65.6200027466
171978803132,2074,813,2887,44.4599990845,30.8999996185,69.0999984741
171978803141,324,210,534,31.6200008392,21.7999992371,78.1999969482
171978803142,1040,165,1205,23.2000007629,16.8799991608,83.1200027466
171978804041,1005,397,1402,22.7099990845,12.8100004196,87.1900024414
171978804042,652,246,898,56.2000007629,13.9499998093,86.0500030518
171978804043,1313,85,1398,96.0199966431,31.9500007629,68.0500030518
171978804044,407,144,551,30.2099990845,6.84000015259,93.1600036621
171978804081,825,557,1382,82.8499984741,46.8899993896,53.1100006104
171978804082,185,313,498,25.5499992371,49.0600013733,50.9399986267
171978804083,954,418,1372,90.6800003052,34.1500015259,65.8499984741
171978804101,1933,20,1953,58.3499984741,1.75999999046,98.2399978638
171978804102,1589,677,2266,42.8300018311,35.0600013733,64.9400024414
171978804111,539,283,822,85.0100021362,35.3499984741,64.6500015259
171978804112,1025,518,1543,82.5599975586,53.4900016785,46.5099983215
171978804113,459,123,582,100.0,52.2599983215,47.7400016785
171978804121,397,269,666,77.7099990845,43.6199989319,56.3800010681
171978804122,926,135,1061,81.9899978638,33.1800003052,66.8199996948
171978804123,858,245,1103,51.2299995422,17.7000007629,82.3000030518
171978804141,357,423,780,50.75,32.5800018311,67.4199981689
171978804142,455,321,776,68.3700027466,42.0600013733,57.9399986267
171978804143,352,177,529,31.1399993896,44.7999992371,55.2000007629
171978804151,2774,395,3169,54.8300018311,21.0200004578,78.9800033569
171978804152,570,248,818,52.0400009155,24.2399997711,75.7600021362
171978804161,500,107,607,39.7000007629,22.6599998474,77.3399963379
171978804162,522,245,767,49.0400009155,27.0599994659,72.9400024414
171978804171,669,195,864,76.3899993896,23.0300006866,76.9700012207
171978804172,1094,0,1094,75.9199981689,0.0,100.0
171978804181,693,198,891,49.3100013733,19.4799995422,80.5199966431
171978804182,1149,28,1177,55.9099998474,6.78000020981,93.2200012207
171978804183,138,327,465,32.0,74.0100021362,25.9899997711
171978804191,708,166,874,38.2200012207,24.8899993896,75.1100006104
171978804192,2366,556,2922,43.6199989319,22.3099994659,77.6900024414
171978804201,789,26,815,21.8999996185,4.30999994278,95.6900024414
171978804202,2924,177,3101,46.9399986267,12.1300001144,87.8700027466
171978804211,722,129,851,28.3799991608,9.63000011444,90.3700027466
171978804212,534,120,654,35.0699996948,12.2299995422,87.7699966431
171978804213,291,18,309,34.6399993896,5.51999998093,94.4800033569
171978805021,617,212,829,58.9199981689,41.6699981689,58.3300018311
171978805022,436,264,700,60.0900001526,51.2200012207,48.7799987793
171978805023,656,86,742,61.3699989319,32.9399986267,67.0599975586
171978805024,659,155,814,60.2999992371,21.5100002289,78.4899978638
171978805031,97,143,240,10.8599996567,41.0600013733,58.9399986267
171978805032,728,274,1002,94.5299987793,37.0499992371,62.9500007629
171978805033,50,237,287,26.4500007629,87.3300018311,12.6700000763
171978805051,195,45,240,19.4799995422,4.07000017166,95.9300003052
171978805052,1440,61,1501,37.2700004578,3.04999995232,96.9499969482
171978805053,424,40,464,43.5299987793,20.2199993134,79.7799987793
171978805054,893,204,1097,70.3700027466,19.7600002289,80.2399978638
171978805071,1329,185,1514,27.6700000763,10.0799999237,89.9199981689
171978805072,898,260,1158,74.0899963379,10.7100000381,89.2900009155
171978806011,740,441,1181,66.8000030518,43.2200012207,56.7799987793
171978806012,706,55,761,57.7799987793,9.43000030518,90.5699996948
171978806021,515,141,656,72.5699996948,19.0699996948,80.9300003052
171978806022,866,247,1113,84.1299972534,31.6100006104,68.3899993896
171978806023,986,262,1248,93.1299972534,32.7700004578,67.2300033569
171978807011,1239,108,1347,62.1599998474,29.0200004578,70.9800033569
171978807012,549,374,923,42.5699996948,51.8100013733,48.1899986267
171978807021,352,139,491,43.2200012207,35.2299995422,64.7699966431
171978807022,326,208,534,85.3000030518,53.3600006104,46.6399993896
171978807023,346,180,526,49.1100006104,31.3600006104,68.6399993896
171978809011,2297,278,2575,57.9799995422,15.779999733,84.2200012207
171978809012,1103,144,1247,70.6900024414,15.7700004578,84.2300033569
171978809031,684,121,805,54.6500015259,11.6599998474,88.3399963379
171978809032,371,169,540,43.9000015259,28.3700008392,71.6299972534
171978809051,909,153,1062,61.9599990845,19.8999996185,80.0999984741
171978809052,312,0,312,32.1599998474,0.0,100.0
171978810011,421,132,553,51.2000007629,7.23000001907,92.7699966431
171978810012,759,171,930,54.8699989319,23.9300003052,76.0699996948
171978810013,574,197,771,62.7299995422,18.4500007629,81.5500030518
171978810014,478,275,753,73.5400009155,37.5400009155,62.4599990845
171978810021,344,332,676,65.5699996948,59.7299995422,40.2700004578
171978810022,223,47,270,22.5599994659,62.3199996948,37.6800003052
171978810023,406,388,794,61.7900009155,59.8400001526,40.1599998474
171978810024,556,195,751,43.4599990845,21.7099990845,78.2900009155
171978810051,376,346,722,48.6199989319,66.4899978638,33.5099983215
171978810052,532,96,628,60.0400009155,12.1199998856,87.8799972534
171978810053,241,3,244,23.0200004578,3.86999988556,96.1299972534
171978810061,271,115,386,34.6199989319,29.9899997711,70.0100021362
171978810062,572,147,719,54.0999984741,20.5,79.5
171978810071,772,509,1281,53.6199989319,63.1100006104,36.8899993896
171978810072,1237,344,1581,51.2299995422,44.3499984741,55.6500015259
171978810091,1565,483,2048,64.4800033569,19.1000003815,80.9000015259
171978810092,1570,513,2083,53.4099998474,28.7600002289,71.2399978638
171978810101,1958,558,2516,66.8399963379,23.1399993896,76.8600006104
171978810111,608,163,771,64.9000015259,34.1500015259,65.8499984741
171978810112,1013,141,1154,52.3800010681,15.8000001907,84.1999969482
171978810121,576,57,633,60.5200004578,10.9399995804,89.0599975586
171978810122,587,33,620,74.9700012207,9.80000019073,90.1999969482
171978810123,622,78,700,60.5,11.0100002289,88.9899978638
171978811051,1030,318,1348,71.3199996948,38.1300010681,61.8699989319
171978811052,1148,256,1404,72.0,27.6800003052,72.3199996948
171978811053,953,310,1263,54.2999992371,47.0999984741,52.9000015259
171978811071,588,615,1203,76.7699966431,49.7900009155,50.2099990845
171978811072,822,302,1124,70.4300003052,32.5200004578,67.4800033569
171978811081,2048,428,2476,55.6699981689,26.1499996185,73.8499984741
171978811082,1177,452,1629,74.4899978638,33.4700012207,66.5299987793
171978811091,219,68,287,21.6299991608,6.05000019073,93.9499969482
171978811092,539,6,545,71.2399978638,20.0200004578,79.9800033569
171978811093,483,204,687,30.0900001526,24.25,75.75
171978811111,710,348,1058,94.8000030518,31.9799995422,68.0199966431
171978811112,247,223,470,34.4799995422,42.5299987793,57.4700012207
171978811113,372,213,585,82.2799987793,43.4399986267,56.5600013733
171978811121,137,310,447,23.8500003815,14.2899999619,85.7099990845
171978811122,1171,67,1238,38.1699981689,6.09999990463,93.9000015259
171978811131,231,55,286,25.4400005341,5.69999980927,94.3000030518
171978811132,16,19,35,3.02999997139,0.0,0.0
171978811133,644,224,868,60.4900016785,13.3400001526,86.6600036621
171978811151,501,3,504,32.8300018311,3.53999996185,96.4599990845
171978811152,0,0,0,0.0,0.0,0.0
171978811153,401,110,511,35.9099998474,17.3199996948,82.6800003052
171978811161,621,74,695,30.7700004578,16.3500003815,83.6500015259
171978811162,995,93,1088,65.7799987793,12.2399997711,87.7600021362
171978812001,522,368,890,51.5,45.1800003052,54.8199996948
171978812002,730,191,921,95.2399978638,43.9599990845,56.0400009155
171978812003,195,114,309,32.8400001526,60.7900009155,39.2099990845
171978812004,225,89,314,26.3400001526,47.0900001526,52.9099998474
171978813011,153,193,346,22.0799999237,67.2200012207,32.7799987793
171978813012,881,128,1009,55.9599990845,15.8500003815,84.1500015259
171978813021,647,54,701,66.1900024414,4.96000003815,95.0400009155
171978813022,725,29,754,90.5199966431,15.779999733,84.2200012207
171978814011,1051,181,1232,87.6200027466,45.0099983215,54.9900016785
171978814012,324,130,454,62.3600006104,20.2399997711,79.7600021362
171978814013,758,271,1029,93.1200027466,44.3100013733,55.6899986267
171978814021,866,165,1031,91.3199996948,37.4099998474,62.5900001526
171978814022,909,12,921,97.25,34.1699981689,65.8300018311
171978814023,703,190,893,85.8700027466,32.8899993896,67.1100006104
171978815001,603,359,962,83.2200012207,48.2200012207,51.7799987793
171978815002,472,266,738,70.4199981689,48.8899993896,51.1100006104
171978815003,866,165,1031,94.6699981689,23.5300006866,76.4700012207
171978816011,246,210,456,55.9500007629,59.1800003052,40.8199996948
171978816012,174,45,219,22.6000003815,27.7999992371,72.1999969482
171978816031,182,261,443,38.2900009155,64.4300003052,35.5699996948
171978816032,1343,351,1694,79.5699996948,18.0900001526,81.9100036621
171978816041,397,32,429,38.5099983215,15.3100004196,84.6900024414
171978816042,566,301,867,59.8800010681,15.9600000381,84.0400009155
171978817001,554,249,803,83.3000030518,47.7900009155,52.2099990845
171978817002,768,452,1220,89.3099975586,53.3400001526,46.6599998474
171978817003,218,590,808,71.8199996948,81.0400009155,18.9599990845
171978818001,785,219,1004,79.8099975586,26.25,73.75
171978818002,783,45,828,98.4499969482,18.3199996948,81.6800003052
171978818003,695,80,775,99.3600006104,36.1399993896,63.8600006104
171978818004,967,74,1041,89.3600006104,28.8500003815,71.1500015259
171978819001,1151,77,1228,97.9300003052,24.0200004578,75.9800033569
171978819002,433,0,433,62.9399986267,32.9199981689,67.0800018311
171978819003,868,59,927,100.0,44.1800003052,55.8199996948
171978819004,889,95,984,93.0100021362,45.9099998474,54.0900001526
171978820001,1049,0,1049,96.8600006104,3.77999997139,96.2200012207
171978820002,743,82,825,95.2699966431,21.9500007629,78.0500030518
171978820003,699,6,705,44.1699981689,7.28999996185,92.7099990845
171978821001,1144,70,1214,88.4800033569,23.1000003815,76.9000015259
171978821002,1506,4,1510,98.8899993896,14.4600000381,85.5400009155
171978822001,767,128,895,99.4400024414,30.0400009155,69.9599990845
171978822002,310,76,386,49.2299995422,21.1200008392,78.8799972534
171978822003,1066,506,1572,96.6200027466,50.5400009155,49.4599990845
171978822004,876,69,945,72.75,35.7000007629,64.3000030518
171978823001,1158,498,1656,94.3099975586,59.2900009155,40.7099990845
171978823002,524,342,866,64.4300003052,41.4300003052,58.5699996948
171978823003,702,185,887,76.9300003052,34.2200012207,65.7799987793
171978824001,1354,182,1536,95.1100006104,44.0,56.0
171978824002,727,191,918,86.5199966431,44.0099983215,55.9900016785
171978824003,559,270,829,100.0,46.7700004578,53.2299995422
171978825001,977,161,1138,98.6100006104,38.4199981689,61.5800018311
171978825002,977,227,1204,99.1800003052,44.0299987793,55.9700012207
171978826011,380,440,820,78.7699966431,77.6800003052,22.3199996948
171978826012,28,308,336,33.1399993896,92.7699966431,7.23000001907
171978826013,269,48,317,30.3600006104,0.0,0.0
171978826021,502,234,736,76.75,34.9099998474,65.0899963379
171978826022,1284,603,1887,98.6399993896,49.2000007629,50.7999992371
171978827011,248,340,588,84.8499984741,70.9599990845,29.0400009155
171978827012,1296,173,1469,86.7699966431,19.0,81.0
171978827021,742,436,1178,97.6800003052,71.8000030518,28.2000007629
171978827022,626,168,794,93.9599990845,38.7099990845,61.2900009155
171978827023,872,160,1032,98.1900024414,48.2999992371,51.7000007629
171978828011,817,90,907,65.9199981689,30.8099994659,69.1900024414
171978828012,1043,83,1126,91.9899978638,21.0900001526,78.9100036621
171978828021,584,194,778,68.3099975586,15.4099998474,84.5899963379
171978828022,611,348,959,89.7900009155,21.2299995422,78.7699966431
171978828023,308,10,318,35.8899993896,4.80000019073,95.1999969482
171978829001,634,418,1052,98.9700012207,59.0299987793,40.9700012207
171978829002,723,535,1258,96.9199981689,32.3199996948,67.6800003052
171978830001,922,229,1151,86.7399978638,31.7999992371,68.1999969482
171978830002,604,446,1050,93.25,48.5200004578,51.4799995422
171978830003,878,275,1153,92.4599990845,56.0099983215,43.9900016785
171978831001,603,342,945,53.4799995422,30.3400001526,69.6600036621
171978831002,477,248,725,74.5899963379,28.0699996948,71.9300003052
171978831003,631,413,1044,69.2300033569,21.8899993896,78.1100006104
171978832061,738,265,1003,54.5099983215,34.2599983215,65.7399978638
171978832062,281,156,437,28.5400009155,43.9900016785,56.0099983215
171978832063,195,38,233,22.7800006866,16.9899997711,83.0100021362
171978832081,785,162,947,61.5699996948,28.4699993134,71.5299987793
171978832082,1034,376,1410,87.0400009155,41.4199981689,58.5800018311
171978832091,185,67,252,26.4699993134,18.3999996185,81.5999984741
171978832092,563,73,636,64.9000015259,24.7099990845,75.2900009155
171978832093,353,152,505,43.1300010681,41.0,59.0
171978832101,750,167,917,60.0099983215,39.4000015259,60.5999984741
171978832102,598,333,931,80.75,60.0900001526,39.9099998474
171978832111,863,200,1063,45.5800018311,15.6899995804,84.3099975586
171978832112,454,179,633,37.5900001526,21.2900009155,78.7099990845
171978832113,1162,315,1477,67.8499984741,21.9799995422,78.0199966431
171978832121,737,467,1204,22.3500003815,22.0599994659,77.9400024414
171978832131,833,114,947,50.1300010681,19.3899993896,80.6100006104
171978832132,537,277,814,77.5999984741,36.1899986267,63.8100013733
171978832133,880,142,1022,39.7000007629,6.76999998093,93.2300033569
171978832141,738,263,1001,42.5999984741,32.6800003052,67.3199996948
171978832151,4617,273,4890,47.7099990845,4.69999980927,95.3000030518
171978832161,746,154,900,65.5,12.9899997711,87.0100021362
171978832162,200,179,379,47.7299995422,35.0400009155,64.9599990845
171978832163,321,156,477,55.3400001526,20.9500007629,79.0500030518
171978833031,-99998,-99998,-99998,-99998.0,-99998.0,-99998.0
171978833032,-99998,-99998,-99998,-99998.0,-99998.0,-99998.0
171978833041,-99998,-99998,-99998,-99998.0,-99998.0,-99998.0
171978833051,422,67,489,29.6700000763,17.7000007629,82.3000030518
171978833052,765,170,935,71.9199981689,27.1399993896,72.8600006104
171978833061,-99998,-99998,-99998,-99998.0,-99998.0,-99998.0
171978833062,-99998,-99998,-99998,-99998.0,-99998.0,-99998.0
171978833071,1483,293,1776,72.4300003052,14.9200000763,85.0800018311
171978833072,708,189,897,54.4300003052,11.279999733,88.7200012207
171978834011,656,237,893,95.8199996948,32.2700004578,67.7300033569
171978834012,364,83,447,33.8400001526,20.4099998474,79.5899963379
171978834013,542,145,687,89.9199981689,24.1299991608,75.8700027466
171978834014,189,253,442,38.3300018311,73.3799972534,26.6200008392
171978834021,-99998,-99998,-99998,-99998.0,-99998.0,-99998.0
171978834022,537,302,839,79.8300018311,30.9699993134,69.0299987793
171978835041,1215,263,1478,52.1699981689,19.5499992371,80.4499969482
171978835042,161,104,265,36.25,12.0799999237,87.9199981689
171978835043,885,420,1305,80.9599990845,17.6800003052,82.3199996948
171978835051,675,27,702,45.6699981689,8.51000022888,91.4899978638
171978835052,857,119,976,42.9599990845,15.470000267,84.5299987793
171978835053,23,65,88,12.4099998474,86.4300003052,13.5699996948
171978835054,369,252,621,28.9400005341,34.2700004578,65.7300033569
171978835055,345,78,423,34.3100013733,7.88999986649,92.1100006104
171978835071,622,120,742,40.2599983215,12.6899995804,87.3099975586
171978835072,1072,169,1241,57.9599990845,9.68000030518,90.3199996948
171978835091,808,93,901,60.8800010681,5.69999980927,94.3000030518
171978835092,955,168,1123,36.6599998474,6.32999992371,93.6699981689
171978835101,663,151,814,40.8199996948,9.39000034332,90.6100006104
171978835102,732,74,806,29.75,10.3400001526,89.6600036621
171978835111,956,68,1024,63.0200004578,7.11999988556,92.8799972534
171978835112,568,18,586,32.1599998474,3.63000011444,96.3700027466
171978835113,625,14,639,43.4700012207,1.97000002861,98.0299987793
171978835131,957,104,1061,55.75,16.2399997711,83.7600021362
171978835132,220,12,232,11.5,5.32000017166,94.6800003052
171978835133,329,61,390,26.7299995422,8.14999961853,91.8499984741
171978835141,545,109,654,18.4599990845,9.31000041962,90.6900024414
171978835142,1902,81,1983,53.5900001526,4.86000013351,95.1399993896
171978835151,897,241,1138,55.7299995422,30.8700008392,69.1299972534
171978835152,277,3,280,21.6700000763,6.90999984741,93.0899963379
171978835153,440,0,440,64.9899978638,0.0,100.0
171978835161,1997,460,2457,41.2000007629,15.1199998856,84.8799972534
171978835162,534,86,620,69.7399978638,16.8099994659,83.1900024414
171978835171,608,150,758,50.4000015259,36.7999992371,63.2000007629
171978835172,642,151,793,42.8400001526,25.1100006104,74.8899993896
171978835191,720,412,1132,45.0999984741,18.9699993134,81.0299987793
171978835192,392,145,537,41.7200012207,53.1500015259,46.8499984741
171978835193,691,184,875,63.2700004578,23.6900005341,76.3099975586
171978835211,402,97,499,35.9500007629,18.1800003052,81.8199996948
171978835212,261,231,492,47.9500007629,51.8899993896,48.1100006104
171978835213,303,94,397,30.5400009155,31.8299999237,68.1699981689
171978835221,207,1,208,19.0,3.24000000954,96.7600021362
171978835222,55,288,343,34.1599998474,92.4700012207,7.53000020981
171978835223,690,98,788,65.6100006104,30.3299999237,69.6699981689
171978836021,548,99,647,65.0899963379,18.6399993896,81.3600006104
171978836022,668,179,847,49.4700012207,28.6700000763,71.3300018311
171978836023,820,118,938,55.4399986267,14.6199998856,85.3799972534
171978836024,421,80,501,40.9599990845,22.9899997711,77.0100021362
171978836031,503,525,1028,71.3899993896,61.7900009155,38.2099990845
171978836032,656,303,959,62.8400001526,74.8799972534,25.1200008392
171978836051,161,9,170,12.6300001144,4.57999992371,95.4199981689
171978836052,721,169,890,50.6800003052,40.7999992371,59.2000007629
171978836061,702,39,741,33.1800003052,17.2900009155,82.7099990845
171978836062,646,216,862,48.9799995422,29.1100006104,70.8899993896
171978837001,723,165,888,70.5299987793,52.1899986267,47.8100013733
171978837002,672,114,786,99.3700027466,24.9699993134,75.0299987793
171978837003,393,274,667,61.3100013733,48.3699989319,51.6300010681
171978838031,896,213,1109,98.1399993896,19.6000003815,80.4000015259
171978838032,260,613,873,60.2900009155,83.0100021362,16.9899997711
171978838041,316,512,828,72.3099975586,67.6100006104,32.3899993896
171978838042,463,411,874,50.7799987793,49.9099998474,50.0900001526
171978838061,411,183,594,62.8600006104,37.7599983215,62.2400016785
171978838062,88,40,128,16.8199996948,39.1500015259,60.8499984741
171978838063,683,174,857,50.2599983215,48.7299995422,51.2700004578
171978838081,854,343,1197,62.5699996948,36.9599990845,63.0400009155
171978838091,668,306,974,80.4300003052,17.5499992371,82.4499969482
171978838092,739,309,1048,58.9099998474,28.8600006104,71.1399993896
171978838101,266,261,527,48.0,65.3799972534,34.6199989319
171978838102,555,181,736,42.6399993896,23.4799995422,76.5199966431
171978838103,240,197,437,48.9399986267,64.7699966431,35.2299995422
171978838111,570,394,964,78.4400024414,53.3300018311,46.6699981689
171978838112,930,347,1277,66.7200012207,22.9200000763,77.0800018311
171978839021,-99998,-99998,-99998,-99998.0,-99998.0,-99998.0
171978839022,735,211,946,51.3600006104,16.0100002289,83.9899978638
171978839023,-99998,-99998,-99998,-99998.0,-99998.0,-99998.0
171978839024,-99998,-99998,-99998,-99998.0,-99998.0,-99998.0
171978839031,-99998,-99998,-99998,-99998.0,-99998.0,-99998.0
171978839041,-99998,-99998,-99998,-99998.0,-99998.0,-99998.0
171978839042,731,281,1012,80.7699966431,24.2399997711,75.7600021362
171978839043,-99998,-99998,-99998,-99998.0,-99998.0,-99998.0
171978840031,-99998,-99998,-99998,-99998.0,-99998.0,-99998.0
171978840032,355,6,361,37.3699989319,11.470000267,88.5299987793
171978840033,-99998,-99998,-99998,-99998.0,-99998.0,-99998.0
171978840041,225,194,419,51.9900016785,63.2599983215,36.7400016785
171978840042,-99998,-99998,-99998,-99998.0,-99998.0,-99998.0
171978840051,-99998,-99998,-99998,-99998.0,-99998.0,-99998.0
171978840061,-99998,-99998,-99998,-99998.0,-99998.0,-99998.0
171978840062,184,7,191,13.6800003052,22.9899997711,77.0100021362
171978841011,1205,146,1351,32.5499992371,25.9699993134,74.0299987793
171978841031,1422,46,1468,53.5800018311,23.9200000763,76.0800018311
171979800001,-99999,-99999,-99999,-99999.0,12.3199996948,87.6800003052
171979801001,966,40,1006,30.8199996948,11.2399997711,88.7600021362
180890101001,0,0,0,0.0,0.0,0.0
180890101002,0,0,0,0.0,0.0,0.0
180890101003,0,0,0,0.0,0.0,0.0
180890101004,0,0,0,0.0,0.0,0.0
180890102011,14,13,27,2.56999993324,0.0,0.0
180890102012,579,103,682,36.3300018311,18.0300006866,81.9700012207
180890102013,36,0,36,2.26999998093,0.0,0.0
180890102014,708,64,772,64.9800033569,29.9899997711,70.0100021362
180890102031,470,19,489,98.0,26.3700008392,73.6299972534
180890102032,740,184,924,73.0999984741,23.2800006866,76.7200012207
180890102033,656,25,681,98.5500030518,18.0699996948,81.9300003052
180890102051,675,3,678,89.2099990845,11.529999733,88.4700012207
180890102052,743,28,771,97.2300033569,8.36999988556,91.6299972534
180890103021,506,192,698,82.3099975586,36.3300018311,63.6699981689
180890103022,400,115,515,91.6399993896,38.3600006104,61.6399993896
180890103023,1062,359,1421,68.1900024414,22.8500003815,77.1500015259
180890103041,597,225,822,84.8300018311,33.5400009155,66.4599990845
180890103042,531,63,594,80.9300003052,34.1300010681,65.8700027466
180890103043,521,55,576,76.4899978638,28.0499992371,71.9499969482
180890103044,682,11,693,95.4499969482,8.57999992371,91.4199981689
180890104001,724,59,783,100.0,21.3099994659,78.6900024414
180890104002,1197,5,1202,100.0,18.2900009155,81.7099990845
180890104003,371,193,564,89.3799972534,44.8199996948,55.1800003052
180890104004,542,94,636,94.7799987793,36.6199989319,63.3800010681
180890105001,477,12,489,50.4599990845,4.69000005722,95.3099975586
180890106001,588,44,632,90.5400009155,14.8199996948,85.1800003052
180890106002,548,56,604,89.3499984741,30.1700000763,69.8300018311
180890109001,343,26,369,97.3600006104,17.4400005341,82.5599975586
180890109002,528,61,589,98.1699981689,25.5400009155,74.4599990845
180890110001,0,0,0,0.0,57.8100013733,42.1899986267
180890110002,482,16,498,79.1699981689,9.27999973297,90.7200012207
180890110003,403,192,595,57.6599998474,38.0,62.0
180890111001,283,94,377,44.7700004578,53.9399986267,46.0600013733
180890111002,637,51,688,51.8899993896,13.3999996185,86.5999984741
180890111003,519,60,579,82.2399978638,23.4300003052,76.5699996948
180890111004,773,265,1038,60.6300010681,46.8300018311,53.1699981689
180890112001,733,53,786,95.6200027466,19.3199996948,80.6800003052
180890112002,463,314,777,79.6900024414,52.9000015259,47.0999984741
180890112003,656,70,726,83.7399978638,23.0799999237,76.9199981689
180890112004,477,67,544,73.4100036621,24.0699996948,75.9300003052
180890112005,834,108,942,95.7300033569,25.3799991608,74.6200027466
180890113001,938,24,962,97.9599990845,10.0699996948,89.9300003052
180890113002,719,95,814,91.5599975586,30.6399993896,69.3600006104
180890114001,354,191,545,83.5899963379,31.6299991608,68.3700027466
180890114002,164,232,396,64.8099975586,24.2299995422,75.7699966431
180890115001,568,138,706,78.0100021362,26.1299991608,73.8700027466
180890115002,695,133,828,80.5400009155,24.7800006866,75.2200012207
180890115003,293,134,427,56.0400009155,24.7900009155,75.2099990845
180890116001,301,127,428,59.8600006104,43.4300003052,56.5699996948
180890116002,360,149,509,51.2099990845,39.8600006104,60.1399993896
180890116003,0,0,0,0.0,0.0,0.0
180890117001,653,78,731,87.7600021362,12.7100000381,87.2900009155
180890118001,540,34,574,80.8499984741,19.9500007629,80.0500030518
180890118002,600,102,702,90.2300033569,29.3400001526,70.6600036621
180890119001,554,41,595,84.4000015259,17.4699993134,82.5299987793
180890119002,577,515,1092,80.7699966431,37.5499992371,62.4500007629
180890120001,490,33,523,99.0500030518,27.3600006104,72.6399993896
180890120002,443,45,488,94.2099990845,24.6900005341,75.3099975586
180890121001,453,24,477,50.6899986267,16.6900005341,83.3099975586
180890122001,3,213,216,44.5400009155,82.5,17.5
180890122002,7,64,71,7.30000019073,0.0,0.0
180890123001,77,73,150,23.9599990845,23.0499992371,76.9499969482
180890123002,342,197,539,80.4499969482,48.0800018311,51.9199981689
180890123003,444,103,547,62.8699989319,25.5499992371,74.4499969482
180890123004,524,139,663,74.5800018311,26.9200000763,73.0800018311
180890124001,693,0,693,100.0,22.9799995422,77.0199966431
180890124002,359,6,365,92.4100036621,0.689999997616,99.3099975586
180890124003,487,234,721,91.5,30.0300006866,69.9700012207
180890124004,574,82,656,91.2399978638,17.6700000763,82.3300018311
180890124005,517,180,697,55.2700004578,18.8600006104,81.1399993896
180890124006,776,118,894,94.1100006104,40.9300003052,59.0699996948
180890125001,602,12,614,43.9500007629,1.61000001431,98.3899993896
180890125002,661,309,970,64.5400009155,42.5699996948,57.4300003052
180890125003,104,134,238,34.0499992371,35.8300018311,64.1699981689
180890125004,779,143,922,59.0600013733,23.4599990845,76.5400009155
180890126001,89,26,115,11.0699996948,16.5499992371,83.4499969482
180890126002,0,0,0,0.0,0.0,0.0
180890126003,446,61,507,47.1199989319,18.2299995422,81.7699966431
180890127001,480,199,679,77.25,58.8600006104,41.1399993896
180890127002,313,100,413,39.1100006104,21.5699996948,78.4300003052
180890127003,496,4,500,89.1299972534,4.01999998093,95.9800033569
180890127004,408,193,601,61.3300018311,33.1100006104,66.8899993896
180890128001,457,0,457,59.9700012207,12.0900001526,87.9100036621
180890128002,306,81,387,48.6800003052,35.4900016785,64.5100021362
180890128003,406,14,420,55.5600013733,7.36000013351,92.6399993896
180890201001,930,60,990,82.9100036621,9.96000003815,90.0400009155
180890201002,570,63,633,85.6600036621,14.6199998856,85.3799972534
180890201003,1260,196,1456,97.5899963379,12.0,88.0
180890201004,511,16,527,39.5299987793,7.86000013351,92.1399993896
180890202001,1210,173,1383,78.5299987793,7.44999980927,92.5500030518
180890202002,545,78,623,74.3399963379,20.3700008392,79.6299972534
180890203001,776,20,796,80.4000015259,5.03999996185,94.9599990845
180890203002,922,150,1072,89.9300003052,31.7399997711,68.2600021362
180890203003,808,59,867,99.4300003052,19.1900005341,80.8099975586
180890203004,1701,383,2084,93.6200027466,8.40999984741,91.5899963379
180890203005,782,144,926,70.0500030518,34.6699981689,65.3300018311
180890204001,762,17,779,63.2799987793,13.0600004196,86.9400024414
180890204002,942,78,1020,93.75,17.5900001526,82.4100036621
180890204003,485,105,590,39.7799987793,8.96000003815,91.0400009155
180890204004,1638,103,1741,96.9400024414,10.9399995804,89.0599975586
180890205001,743,156,899,100.0,28.25,71.75
180890205002,999,203,1202,100.0,20.9099998474,79.0899963379
180890205003,979,59,1038,99.8099975586,12.8100004196,87.1900024414
180890205004,803,30,833,99.0500030518,12.25,87.75
180890206001,763,123,886,74.2699966431,12.7299995422,87.2699966431
180890206002,1003,27,1030,95.8099975586,6.01999998093,93.9800033569
180890207001,1580,65,1645,100.0,20.4400005341,79.5599975586
180890207002,638,35,673,77.3600006104,0.0,100.0
180890207003,118,4,122,12.0699996948,15.2299995422,84.7699966431
180890207004,237,11,248,28.7399997711,9.34000015259,90.6600036621
180890207005,781,0,781,99.6200027466,0.0,100.0
180890208001,775,53,828,84.1500015259,0.0,100.0
180890208002,579,21,600,51.1500015259,5.82999992371,94.1699981689
180890208003,696,57,753,65.4199981689,8.10999965668,91.8899993896
180890208004,604,31,635,56.4399986267,12.0699996948,87.9300003052
180890209001,1211,375,1586,77.1399993896,7.76999998093,92.2300033569
180890209002,155,101,256,30.1900005341,40.9300003052,59.0699996948
180890209003,749,65,814,54.6300010681,12.3100004196,87.6900024414
180890210001,249,9,258,34.3100013733,11.7899999619,88.2099990845
180890210002,937,1,938,92.7799987793,7.28000020981,92.7200012207
180890210003,856,156,1012,94.3199996948,21.1299991608,78.8700027466
180890210004,400,115,515,76.4100036621,37.8899993896,62.1100006104
180890210005,1377,78,1455,85.8899993896,3.07999992371,96.9199981689
180890211001,589,33,622,89.2399978638,5.03999996185,94.9599990845
180890211002,486,8,494,84.4400024414,4.44999980927,95.5500030518
180890211003,393,82,475,48.0299987793,38.8100013733,61.1899986267
180890211004,313,13,326,43.8800010681,5.63000011444,94.3700027466
180890213001,1026,14,1040,93.9499969482,20.2999992371,79.6999969482
180890213002,293,78,371,35.6699981689,22.4899997711,77.5100021362
180890213003,575,96,671,45.25,23.1499996185,76.8499984741
180890214001,852,46,898,54.0299987793,19.7800006866,80.2200012207
180890214002,1033,80,1113,99.1100006104,12.3199996948,87.6800003052
180890214003,704,104,808,53.1899986267,8.75,91.25
180890214004,550,185,735,85.1699981689,25.4200000763,74.5800018311
180890215001,496,141,637,97.8499984741,49.6399993896,50.3600006104
180890215002,367,346,713,100.0,50.7999992371,49.2000007629
180890215003,508,380,888,97.6900024414,44.9799995422,55.0200004578
180890216001,1015,69,1084,99.1800003052,17.4200000763,82.5800018311
180890216002,398,12,410,46.3800010681,11.7399997711,88.2600021362
180890216003,16,0,16,1.54999995232,0.0,0.0
180890217001,383,235,618,94.9300003052,49.7700004578,50.2299995422
180890217002,336,639,975,75.4599990845,51.5499992371,48.4500007629
180890217003,6,392,398,40.3699989319,79.2600021362,20.7399997711
180890217004,442,78,520,45.0999984741,20.1000003815,79.9000015259
180890217005,768,2,770,90.5899963379,1.28999996185,98.7099990845
180890218001,193,0,193,27.8500003815,0.0,100.0
180890218002,205,362,567,89.1500015259,59.2999992371,40.7000007629
180890218003,0,0,0,0.0,0.0,0.0
180890218004,536,0,536,43.1899986267,0.0,100.0
180890219001,907,416,1323,81.9700012207,42.4000015259,57.5999984741
180890219002,687,167,854,68.8700027466,25.5400009155,74.4599990845
180890219003,1029,90,1119,91.8700027466,39.5499992371,60.4500007629
180890219004,625,133,758,68.9700012207,20.9099998474,79.0899963379
180890220001,700,7,707,56.25,9.73999977112,90.2600021362
180890220002,415,22,437,54.0800018311,3.77999997139,96.2200012207
180890220003,672,36,708,43.8899993896,10.0100002289,89.9899978638
180890220004,370,195,565,41.1800003052,45.1399993896,54.8600006104
180890301001,1456,0,1456,100.0,3.00999999046,96.9899978638
180890302001,893,8,901,95.2399978638,19.7600002289,80.2399978638
180890302002,379,3,382,75.7900009155,35.5600013733,64.4400024414
180890303001,642,43,685,84.5699996948,8.60000038147,91.4000015259
180890303002,487,106,593,32.4199981689,8.02000045776,91.9800033569
180890304001,662,8,670,97.2399978638,5.13000011444,94.8700027466
180890304002,1137,30,1167,81.6100006104,5.38999986649,94.6100006104
180890304003,1095,144,1239,96.8000030518,15.3900003433,84.6100006104
180890305001,550,51,601,64.5500030518,7.84000015259,92.1600036621
180890305002,291,116,407,52.7900009155,22.6700000763,77.3300018311
180890305003,771,140,911,71.5100021362,15.8900003433,84.1100006104
180890305004,1219,0,1219,99.1900024414,0.870000004768,99.1299972534
180890306001,819,97,916,62.2700004578,13.4300003052,86.5699996948
180890306002,623,137,760,63.5999984741,0.0,0.0
180890306003,324,429,753,70.6999969482,34.3400001526,65.6600036621
180890306004,1193,92,1285,94.7600021362,4.5,95.5
180890307001,847,8,855,95.1100006104,8.31000041962,91.6900024414
180890307002,533,42,575,48.6899986267,5.53999996185,94.4599990845
180890308001,466,0,466,54.5,0.0,100.0
180890308002,458,19,477,61.0800018311,4.21999979019,95.7799987793
180890308003,1154,0,1154,85.0400009155,1.25999999046,98.7399978638
180890308004,1039,163,1202,96.6200027466,19.0799999237,80.9199981689
180890309001,504,16,520,41.2999992371,0.0,0.0
180890309002,926,14,940,94.2799987793,18.1000003815,81.9000015259
180890309003,693,21,714,55.9099998474,11.3999996185,88.5999984741
180890310001,549,175,724,81.8099975586,15.3100004196,84.6900024414
180890310002,403,90,493,73.3600006104,26.0200004578,73.9800033569
180890401001,355,36,391,60.6199989319,11.3400001526,88.6600036621
180890401002,316,65,381,49.6699981689,14.75,85.25
180890402001,646,32,678,44.4000015259,0.0,100.0
180890402002,1160,0,1160,99.6600036621,0.5,99.5
180890402003,359,0,359,44.8199996948,0.0,0.0
180890403001,358,0,358,42.3699989319,3.75999999046,96.2399978638
180890403002,810,99,909,75.8799972534,17.7900009155,82.2099990845
180890403003,747,64,811,23.9799995422,4.32000017166,95.6800003052
180890403004,592,396,988,98.5999984741,44.6800003052,55.3199996948
180890403005,593,105,698,98.1699981689,24.8600006104,75.1399993896
180890403006,178,180,358,49.0400009155,51.0099983215,48.9900016785
180890404011,44,229,273,34.8699989319,87.6600036621,12.3400001526
180890404012,135,320,455,31.3400001526,76.1900024414,23.8099994659
180890404013,241,298,539,32.9099998474,62.0999984741,37.9000015259
180890404014,573,136,709,52.5600013733,28.0799999237,71.9199981689
180890404021,928,322,1250,49.7799987793,15.6499996185,84.3499984741
180890404022,554,157,711,34.6800003052,17.9300003052,82.0699996948
180890404031,485,133,618,22.3099994659,26.5599994659,73.4400024414
180890404032,886,75,961,65.2399978638,6.32000017166,93.6800003052
180890404033,7,3,10,0.569999992847,0.0,0.0
180890405011,292,0,292,24.3299999237,0.0,100.0
180890405012,667,189,856,77.5400009155,21.5599994659,78.4400024414
180890405013,1009,207,1216,93.8300018311,12.5,87.5
180890405021,992,168,1160,59.0299987793,11.1400003433,88.8600006104
180890405022,681,65,746,48.5400009155,10.8500003815,89.1500015259
180890406001,356,224,580,68.0,35.5900001526,64.4100036621
180890406002,629,54,683,84.1100006104,8.93999958038,91.0599975586
180890406003,804,193,997,84.2099990845,29.1700000763,70.8300018311
180890406004,329,128,457,49.5099983215,10.529999733,89.4700012207
180890407001,188,21,209,11.2700004578,5.05999994278,94.9400024414
180890407002,43,18,61,5.15000009537,0.0,0.0
180890407003,26,28,54,5.15999984741,0.0,0.0
180890407004,669,70,739,79.0400009155,7.19999980927,92.8000030518
180890408011,639,95,734,48.7700004578,23.8099994659,76.1900024414
180890408012,483,196,679,50.0400009155,46.5299987793,53.4700012207
180890408013,569,312,881,86.8799972534,46.9300003052,53.0699996948
180890408021,335,66,401,33.6699981689,18.1900005341,81.8099975586
180890408022,401,0,401,38.7799987793,0.389999985695,99.6100006104
180890408023,648,125,773,80.1900024414,19.5300006866,80.4700012207
180890408024,86,30,116,16.4099998474,29.9500007629,70.0500030518
180890409001,600,195,795,39.9700012207,28.3199996948,71.6800003052
180890409002,417,282,699,71.3300018311,45.4799995422,54.5200004578
180890409003,803,219,1022,61.7900009155,19.2399997711,80.7600021362
180890409004,1050,55,1105,55.8100013733,9.52000045776,90.4800033569
180890410011,419,0,419,18.6900005341,0.0,100.0
180890410012,840,99,939,65.2099990845,15.1400003433,84.8600006104
180890410013,855,226,1081,58.2400016785,29.7900009155,70.2099990845
180890410021,568,243,811,63.8100013733,24.8500003815,75.1500015259
180890410022,833,352,1185,71.9499969482,37.6300010681,62.3699989319
180890410023,1093,347,1440,82.1900024414,35.7000007629,64.3000030518
180890411001,272,12,284,36.2700004578,8.15999984741,91.8399963379
180890411002,155,91,246,28.8700008392,34.1399993896,65.8600006104
180890411003,428,39,467,62.1800003052,12.2399997711,87.7600021362
180890412001,544,100,644,80.3000030518,20.7999992371,79.1999969482
180890412002,454,268,722,65.6399993896,35.9799995422,64.0199966431
180890412003,404,133,537,92.2699966431,32.6800003052,67.3199996948
180890413021,332,294,626,65.2799987793,45.2999992371,54.7000007629
180890413022,770,508,1278,70.3700027466,46.4700012207,53.5299987793
180890414001,229,258,487,56.1100006104,65.8099975586,34.1899986267
180890414002,484,447,931,82.8300018311,69.9700012207,30.0300006866
180890414003,633,123,756,88.8399963379,48.5699996948,51.4300003052
180890415001,355,206,561,33.5099983215,41.2000007629,58.7999992371
180890416001,200,131,331,21.1100006104,54.8100013733,45.1899986267
180890416002,363,54,417,40.6800003052,16.0599994659,83.9400024414
180890416003,267,81,348,51.6300010681,23.6700000763,76.3300018311
180890416004,1003,61,1064,76.4400024414,17.8700008392,82.1299972534
180890417001,1237,42,1279,93.0199966431,8.81000041962,91.1900024414
180890417002,277,187,464,72.8399963379,23.6700000763,76.3300018311
180890417003,637,160,797,79.3799972534,20.3099994659,79.6900024414
180890417004,616,111,727,94.0500030518,36.9300003052,63.0699996948
180890417005,409,284,693,81.6299972534,48.4900016785,51.5099983215
180890418001,379,23,402,43.2299995422,10.779999733,89.2200012207
180890418002,404,143,547,65.0400009155,34.8199996948,65.1800003052
180890418003,456,193,649,66.5599975586,31.4099998474,68.5899963379
180890418004,54,198,252,37.4399986267,84.2699966431,15.7299995422
180890418005,479,164,643,64.6200027466,27.6900005341,72.3099975586
180890418006,786,124,910,92.0100021362,14.6599998474,85.3399963379
180890418007,312,157,469,43.7099990845,52.0499992371,47.9500007629
180890419001,789,139,928,40.6699981689,25.9400005341,74.0599975586
180890419002,428,178,606,46.0800018311,37.3499984741,62.6500015259
180890419003,974,153,1127,84.8000030518,27.7900009155,72.2099990845
180890420001,293,134,427,52.2000007629,37.1399993896,62.8600006104
180890420002,1050,240,1290,38.4199981689,37.9900016785,62.0099983215
180890420003,779,254,1033,65.0899963379,37.0,63.0
180890420004,2,0,2,0.25,0.0,0.0
180890421001,1565,497,2062,86.6399993896,49.75,50.25
180890421002,604,138,742,43.4900016785,25.3999996185,74.5999984741
180890421003,507,26,533,78.5,8.77000045776,91.2300033569
180890421004,589,61,650,86.6699981689,13.7100000381,86.2900009155
180890422001,657,273,930,87.0,50.4099998474,49.5900001526
180890422002,470,128,598,49.2999992371,31.6900005341,68.3099975586
180890422003,524,68,592,54.7099990845,29.0900001526,70.9100036621
180890422004,759,314,1073,93.1399993896,43.9000015259,56.0999984741
180890422005,1065,327,1392,67.3099975586,32.9700012207,67.0299987793
180890423001,452,58,510,32.8400001526,14.1400003433,85.8600006104
180890423002,832,423,1255,43.3100013733,33.4199981689,66.5800018311
180890423003,835,175,1010,35.5800018311,18.9699993134,81.0299987793
180890424011,552,119,671,36.2299995422,33.0299987793,66.9700012207
180890424012,461,345,806,34.2799987793,52.4700012207,47.5299987793
180890424013,878,661,1539,68.1900024414,44.1399993896,55.8600006104
180890424021,417,147,564,34.2599983215,36.9199981689,63.0800018311
180890424022,120,100,220,8.25,47.4399986267,52.5600013733
180890424023,988,502,1490,78.6699981689,29.5,70.5
180890424024,473,140,613,66.7799987793,18.2900009155,81.7099990845
180890424031,546,83,629,37.3100013733,11.9099998474,88.0899963379
180890424032,1151,166,1317,53.0200004578,10.7399997711,89.2600021362
180890425011,703,68,771,52.9900016785,10.3299999237,89.6699981689
180890425012,829,147,976,35.0099983215,17.1399993896,82.8600006104
180890425013,940,39,979,49.4900016785,4.30000019073,95.6999969482
180890425031,1340,396,1736,55.6599998474,21.1100006104,78.8899993896
180890425041,2335,349,2684,71.7300033569,18.75,81.25
180890425042,559,57,616,40.3100013733,22.2900009155,77.7099990845
180890425043,629,80,709,34.2000007629,4.88999986649,95.1100006104
180890425051,879,117,996,27.6499996185,9.21000003815,90.7900009155
180890425052,1097,114,1211,72.7799987793,13.220000267,86.7799987793
180890425053,398,12,410,43.9900016785,6.59999990463,93.4000015259
180890426021,679,371,1050,37.9900016785,48.8800010681,51.1199989319
180890426022,1308,472,1780,48.7799987793,26.7199993134,73.2799987793
180890426051,81,14,95,3.65000009537,24.7399997711,75.2600021362
180890426052,1348,227,1575,34.5200004578,20.6700000763,79.3300018311
180890426061,974,283,1257,77.1200027466,32.1500015259,67.8499984741
180890426062,601,118,719,42.3199996948,20.8199996948,79.1800003052
180890426071,184,40,224,10.8299999237,18.8099994659,81.1900024414
180890426072,1042,392,1434,71.5199966431,37.75,62.25
180890426073,597,374,971,29.9500007629,47.4900016785,52.5099983215
180890426081,1433,376,1809,41.1699981689,24.5,75.5
180890426091,1613,364,1977,57.4000015259,27.5200004578,72.4800033569
180890426092,735,231,966,34.4300003052,43.3300018311,56.6699981689
180890426093,510,211,721,33.0299987793,54.0,46.0
180890427021,841,142,983,84.3799972534,34.0099983215,65.9899978638
180890427022,1408,60,1468,74.5199966431,7.65999984741,92.3399963379
180890427023,648,142,790,33.2799987793,14.0200004578,85.9800033569
180890427031,963,88,1051,54.0400009155,7.82999992371,92.1699981689
180890427032,54,0,54,6.05999994278,7.98000001907,92.0199966431
180890427033,177,5,182,8.93999958038,2.19000005722,97.8099975586
180890427041,1107,315,1422,68.6999969482,28.6900005341,71.3099975586
180890427042,1418,328,1746,72.9300003052,21.2700004578,78.7300033569
180890428011,40,141,181,20.7600002289,85.5599975586,14.4399995804
180890428012,1320,136,1456,49.6899986267,20.1800003052,79.8199996948
180890428013,1194,91,1285,49.2299995422,9.27999973297,90.7200012207
180890428014,654,123,777,28.4200000763,9.89000034332,90.1100006104
180890428021,444,160,604,52.2900009155,36.6800003052,63.3199996948
180890428022,720,455,1175,54.2700004578,46.1399993896,53.8600006104
180890428023,523,312,835,37.0800018311,33.8199996948,66.1800003052
180890429011,325,183,508,32.1699981689,48.3400001526,51.6599998474
180890429012,406,45,451,25.6800003052,17.3099994659,82.6900024414
180890429013,657,339,996,35.3800010681,43.8699989319,56.1300010681
180890429021,1105,100,1205,26.8899993896,13.8900003433,86.1100006104
180890429022,931,118,1049,56.9500007629,16.4799995422,83.5199966431
180890430011,557,325,882,37.0099983215,23.9200000763,76.0800018311
180890430012,439,37,476,21.7900009155,5.17000007629,94.8300018311
180890430021,806,147,953,87.1100006104,10.9499998093,89.0500030518
180890430022,1190,104,1294,73.1500015259,19.2700004578,80.7300033569
180890430023,1368,459,1827,71.3700027466,36.3699989319,63.6300010681
180890431011,638,346,984,34.1100006104,41.8699989319,58.1300010681
180890431021,586,542,1128,34.3100013733,58.9300003052,41.0699996948
180890431022,1104,634,1738,61.1500015259,32.4199981689,67.5800018311
180890431023,384,310,694,46.4799995422,57.4900016785,42.5099983215
180890432011,153,153,306,60.4700012207,44.6199989319,55.3800010681
180890432012,625,131,756,36.6800003052,37.4000015259,62.5999984741
180890432013,136,186,322,37.8400001526,69.3000030518,30.7000007629
180890432021,2404,376,2780,72.2099990845,16.8500003815,83.1500015259
180890432022,1036,149,1185,29.9599990845,15.5399999619,84.4599990845
180890433001,14,7,21,1.22000002861,55.0200004578,44.9799995422
180890433002,430,101,531,18.0,28.1499996185,71.8499984741
180890433003,1367,123,1490,27.3400001526,18.2800006866,81.7200012207
180890434011,676,208,884,29.8400001526,9.96000003815,90.0400009155
180890434012,-99998,-99998,-99998,-99998.0,-99998.0,-99998.0
180890434013,-99998,-99998,-99998,-99998.0,-99998.0,-99998.0
180890434031,724,240,964,71.0400009155,31.4400005341,68.5599975586
180890434032,427,316,743,73.4199981689,40.5200004578,59.4799995422
180890434033,805,317,1122,62.5800018311,22.1200008392,77.8799972534
180890434034,214,132,346,14.2700004578,52.6699981689,47.3300018311
180890434041,-99998,-99998,-99998,-99998.0,-99998.0,-99998.0
180890434051,31,5,36,2.25999999046,25.4599990845,74.5400009155
180890434052,859,47,906,36.0699996948,17.7099990845,82.2900009155
180890434053,-99998,-99998,-99998,-99998.0,-99998.0,-99998.0
180910401001,769,102,871,93.3499984741,33.7200012207,66.2799987793
180910401002,1653,230,1883,83.2399978638,36.9799995422,63.0200004578
180910401003,513,81,594,84.8600006104,40.8100013733,59.1899986267
180910403001,619,0,619,100.0,1.89999997616,98.0999984741
180910403002,866,113,979,89.7300033569,9.22999954224,90.7699966431
180910403003,57,1,58,5.94000005722,0.0,100.0
180910404001,397,366,763,57.1500015259,51.6899986267,48.3100013733
180910404002,644,74,718,75.0999984741,30.3700008392,69.6299972534
180910404003,194,138,332,38.5999984741,20.8500003815,79.1500015259
180910405001,301,331,632,68.7699966431,75.5500030518,24.4500007629
180910405002,238,180,418,69.6699981689,58.5,41.5
180910405003,928,298,1226,63.9500007629,32.6800003052,67.3199996948
180910406001,587,207,794,89.8199996948,37.4000015259,62.5999984741
180910406002,754,739,1493,80.8799972534,66.1999969482,33.7999992371
180910406003,914,861,1775,84.2399978638,49.9799995422,50.0200004578
180910407001,518,193,711,85.4599990845,48.6599998474,51.3400001526
180910407002,274,74,348,49.4300003052,47.0699996948,52.9300003052
180910408001,536,107,643,60.0400009155,3.76999998093,96.2300033569
180910408002,847,121,968,99.9000015259,27.8400001526,72.1600036621
180910408003,695,210,905,95.6699981689,41.4900016785,58.5099983215
180910409001,1121,206,1327,47.8899993896,15.6300001144,84.3700027466
180910411001,467,0,467,38.0,0.0,100.0
180910411002,192,1,193,19.7700004578,13.4099998474,86.5899963379
180910412001,-99998,-99998,-99998,-99998.0,-99998.0,-99998.0
180910412002,-99998,-99998,-99998,-99998.0,-99998.0,-99998.0
180910413001,479,170,649,39.1199989319,42.9399986267,57.0600013733
180910413002,398,198,596,60.8199996948,35.9799995422,64.0199966431
180910414001,286,175,461,41.6100006104,38.0800018311,61.9199981689
180910414002,493,3,496,54.8699989319,15.7700004578,84.2300033569
180910414003,560,166,726,39.2599983215,13.3100004196,86.6900024414
180910415001,894,315,1209,50.9900016785,41.5499992371,58.4500007629
180910415002,343,128,471,46.1300010681,36.9300003052,63.0699996948
180910415003,813,126,939,57.8600006104,41.8899993896,58.1100006104
180910416001,-99998,-99998,-99998,-99998.0,-99998.0,-99998.0
180910416002,622,109,731,38.4500007629,37.8100013733,62.1899986267
180910416003,521,122,643,25.9699993134,48.2200012207,51.7799987793
180910416004,248,102,350,41.9199981689,34.0900001526,65.9100036621
180910417001,-99998,-99998,-99998,-99998.0,-99998.0,-99998.0
180910417002,-99998,-99998,-99998,-99998.0,-99998.0,-99998.0
180910417003,-99998,-99998,-99998,-99998.0,-99998.0,-99998.0
180910418001,-99998,-99998,-99998,-99998.0,-99998.0,-99998.0
180910418002,702,50,752,51.5099983215,31.0200004578,68.9800033569
180910418003,-99998,-99998,-99998,-99998.0,-99998.0,-99998.0
180910418004,689,97,786,39.9199981689,22.4599990845,77.5400009155
180910419001,-99998,-99998,-99998,-99998.0,-99998.0,-99998.0
180910419002,-99998,-99998,-99998,-99998.0,-99998.0,-99998.0
180910419003,322,61,383,37.6199989319,26.0400009155,73.9599990845
180910419004,288,35,323,33.1599998474,21.0900001526,78.9100036621
180910419005,470,78,548,51.1199989319,22.6499996185,77.3499984741
180910420001,567,191,758,44.4599990845,31.6700000763,68.3300018311
180910420002,381,257,638,77.8000030518,46.8300018311,53.1699981689
180910421001,693,71,764,90.4100036621,12.1499996185,87.8499984741
180910421002,742,134,876,96.0500030518,23.6399993896,76.3600006104
180910421003,731,305,1036,82.6800003052,53.8499984741,46.1500015259
180910421004,549,87,636,47.1800003052,26.3799991608,73.6200027466
180910421005,1272,267,1539,75.4400024414,20.6499996185,79.3499984741
180910422001,1057,256,1313,94.3199996948,46.7299995422,53.2700004578
180910422002,725,568,1293,72.2300033569,50.0499992371,49.9500007629
180910423001,985,37,1022,99.7099990845,27.4599990845,72.5400009155
180910423002,1186,59,1245,93.6800003052,18.6900005341,81.3099975586
180910424001,423,238,661,77.6699981689,50.6100006104,49.3899993896
180910424002,694,70,764,91.5,14.9200000763,85.0800018311
180910424003,532,200,732,55.5800018311,34.0299987793,65.9700012207
180910424004,1494,342,1836,66.7399978638,17.4200000763,82.5800018311
180910424005,780,455,1235,73.3799972534,27.3500003815,72.6500015259
180910425001,585,114,699,86.4000015259,17.5499992371,82.4499969482
180910425002,764,174,938,31.1800003052,30.2999992371,69.6999969482
180910425003,666,302,968,82.8799972534,43.6699981689,56.3300018311
180910426001,810,109,919,62.0499992371,21.6200008392,78.3799972534
180910426002,768,119,887,57.9000015259,21.5699996948,78.4300003052
180910426003,827,160,987,28.6900005341,22.2299995422,77.7699966431
180910426004,1457,149,1606,70.4400024414,20.9500007629,79.0500030518
180910427001,468,102,570,34.6500015259,23.6299991608,76.3700027466
180910427002,502,139,641,48.4500007629,23.1900005341,76.8099975586
180910427003,-99998,-99998,-99998,-99998.0,-99998.0,-99998.0
180910427004,435,189,624,54.1699981689,31.1800003052,68.8199996948
180910428001,500,140,640,42.3800010681,14.6300001144,85.3700027466
180910428002,688,56,744,49.2700004578,9.63000011444,90.3700027466
180910429001,238,10,248,34.1599998474,7.07000017166,92.9300003052
180910429002,379,22,401,34.7799987793,13.3599996567,86.6399993896
180910429003,-99998,-99998,-99998,-99998.0,-99998.0,-99998.0
180910430001,67,35,102,14.0500001907,0.0,100.0
180910430002,1598,39,1637,96.2900009155,16.6000003815,83.4000015259
181270501011,275,10,285,27.0699996948,11.0,89.0
181270501012,1119,157,1276,39.2400016785,18.8099994659,81.1900024414
181270501013,831,141,972,32.7200012207,27.3600006104,72.6399993896
181270501014,1249,134,1383,67.4300003052,30.4500007629,69.5500030518
181270501031,0,0,0,0.0,0.0,0.0
181270501032,532,165,697,94.0599975586,54.4300003052,45.5699996948
181270501033,332,79,411,32.4599990845,38.4599990845,61.5400009155
181270501034,932,404,1336,55.1800003052,49.4799995422,50.5200004578
181270501035,652,176,828,55.3499984741,60.9700012207,39.0299987793
181270501036,578,100,678,41.9300003052,40.8499984741,59.1500015259
181270502021,470,448,918,71.3300018311,60.8800010681,39.1199989319
181270502022,205,128,333,51.6300010681,37.1599998474,62.8400001526
181270502023,332,284,616,87.6200027466,56.4399986267,43.5600013733
181270502024,271,96,367,55.4399986267,51.5999984741,48.4000015259
181270502025,1148,575,1723,58.7900009155,51.2400016785,48.7599983215
181270502031,430,40,470,22.6599998474,31.2800006866,68.7200012207
181270502032,997,299,1296,63.6899986267,46.75,53.25
181270502033,1629,469,2098,82.6999969482,34.1199989319,65.8799972534
181270503001,530,261,791,79.5,33.2400016785,66.7600021362
181270503002,639,454,1093,70.8399963379,48.3100013733,51.6899986267
181270503003,216,309,525,51.8300018311,81.25,18.75
181270503004,1120,340,1460,49.0099983215,26.25,73.75
181270504021,1548,509,2057,72.3499984741,43.4300003052,56.5699996948
181270504022,1141,547,1688,62.2599983215,48.2700004578,51.7299995422
181270504023,737,144,881,82.1100006104,36.5400009155,63.4599990845
181270504024,871,147,1018,79.7200012207,39.3699989319,60.6300010681
181270504051,93,0,93,8.40999984741,27.1299991608,72.8700027466
181270504071,320,101,421,48.6100006104,19.6299991608,80.3700027466
181270504072,683,380,1063,76.9700012207,49.9900016785,50.0099983215
181270504073,919,281,1200,79.3700027466,39.5999984741,60.4000015259
181270505011,777,176,953,52.4500007629,43.3600006104,56.6399993896
181270505012,980,740,1720,64.3499984741,53.4000015259,46.5999984741
181270505013,970,230,1200,72.9899978638,35.6100006104,64.3899993896
181270505031,1021,499,1520,57.0400009155,39.2599983215,60.7400016785
181270505032,274,213,487,52.9300003052,43.7099990845,56.2900009155
181270505033,207,50,257,15.9099998474,0.0,100.0
181270505051,293,156,449,18.0900001526,33.9099998474,66.0899963379
181270505061,1622,129,1751,69.8199996948,17.8899993896,82.1100006104
181270505062,961,96,1057,33.4700012207,9.19999980927,90.8000030518
181270505071,1746,103,1849,65.3399963379,15.3000001907,84.6999969482
181270505072,563,76,639,58.5200004578,20.0200004578,79.9800033569
181270505081,694,133,827,34.9099998474,28.7600002289,71.2399978638
181270505082,761,318,1079,57.8600006104,24.4200000763,75.5800018311
181270505083,1462,177,1639,89.8099975586,24.3999996185,75.5999984741
181270505091,655,146,801,39.2999992371,23.6299991608,76.3700027466
181270505092,1711,139,1850,67.1999969482,18.9400005341,81.0599975586
181270506021,684,461,1145,43.9900016785,54.0400009155,45.9599990845
181270506022,461,334,795,43.6300010681,43.4500007629,56.5499992371
181270506031,729,256,985,28.7800006866,34.7299995422,65.2699966431
181270506041,207,65,272,21.5,22.8799991608,77.1200027466
181270506042,613,194,807,29.7299995422,40.6699981689,59.3300018311
181270506043,1153,311,1464,47.7000007629,46.4500007629,53.5499992371
181270506044,320,84,404,38.9599990845,31.2099990845,68.7900009155
181270507021,545,326,871,61.2900009155,33.5299987793,66.4700012207
181270507022,1605,353,1958,68.8000030518,45.8300018311,54.1699981689
181270507023,1458,457,1915,86.2600021362,44.3400001526,55.6599998474
181270507024,1190,358,1548,92.75,34.1599998474,65.8399963379
181270507031,834,445,1279,79.5400009155,53.6100006104,46.3899993896
181270507032,1044,471,1515,84.3099975586,45.4900016785,54.5099983215
181270507041,1105,431,1536,48.4399986267,36.2900009155,63.7099990845
181270507042,928,130,1058,63.0900001526,19.6499996185,80.3499984741
181270508001,734,268,1002,92.0100021362,31.1499996185,68.8499984741
181270508002,1236,233,1469,78.3000030518,24.0900001526,75.9100036621
181270508003,1325,246,1571,84.4199981689,30.5499992371,69.4499969482
181270508004,1579,68,1647,89.3199996948,13.6999998093,86.3000030518
181270509001,2067,114,2181,87.2699966431,12.779999733,87.2200012207
181270509002,347,19,366,21.5900001526,12.720000267,87.2799987793
181270510021,772,95,867,56.8499984741,17.7700004578,82.2300033569
181270510022,1024,25,1049,28.6299991608,12.0399999619,87.9599990845
181270510023,1589,313,1902,58.5200004578,12.6000003815,87.4000015259
181270510051,417,48,465,27.4799995422,37.6199989319,62.3800010681
181270510052,474,290,764,27.9799995422,43.3899993896,56.6100006104
181270510061,558,69,627,20.9099998474,18.6499996185,81.3499984741
181270510062,482,121,603,42.2599983215,39.2400016785,60.7599983215
181270510071,167,116,283,9.13000011444,49.7799987793,50.2200012207
181270510072,796,46,842,38.2599983215,28.3999996185,71.5999984741
181270510073,435,60,495,26.1100006104,32.7599983215,67.2399978638
181270510081,590,70,660,30.9599990845,18.4699993134,81.5299987793
181270511011,-99998,-99998,-99998,-99998.0,-99998.0,-99998.0
181270511012,1163,222,1385,59.6199989319,25.7700004578,74.2300033569
181270511013,718,105,823,62.9700012207,19.6200008392,80.3799972534
181270511021,-99998,-99998,-99998,-99998.0,-99998.0,-99998.0
181270511022,1068,262,1330,59.8600006104,22.0400009155,77.9599990845
181279800011,0,0,0,0.0,0.0,100.0
181279800021,0,0,0,0.0,0.0,0.0
